It is the Year of Our Lord MMXVIII. You have arrived in the Danish city of Copenhagen to pursue a master's degree. You found an apartment for let in the suburb of Hellerup, and promptly moved in. The place isn't much, but for the next two years it's home. 

PREPARE YOUR SPIRIT FOR . . .

RYAN QUEST 2
An Interactive Fiction by Maxwell Joslyn
Release 1 / Serial number 181230 / Inform 7 build 6M62 (I6/v6.33 lib 6/12N) SD

Apartment
Your apartment is a cheery little cube. On the east wall is a round window. A woven rug adorns the floor in the middle of the room. Along the west wall are a fridge and some shelves. A bed lies in the northwest corner, and a stove lies in the northeast.

On the stove is a frying pan.

On the shelves is a loaf of bread.

You can also see an apartment door, a backpack (empty), a dwarf banana tree, a fridge (closed) and the bed (on which are bedsheets and a pair of Central European panties) here.

I beg your pardon?

I beg your pardon?

>south
(first opening the apartment door)
You can't go to school without your backpack.

>get pack
Taken.

>south
(first opening the apartment door)

Hellerup Strandvejen
The main street of Hellerup is bordered on its north side by brightly-painted row houses, such as the one containing your apartment. At the east end is a dock, and if you go west you can catch a train.

You can see an apartment door, a street vendor and a wheelbarrow (in which are a pile of herring and a mound of herring) here.

>push wheelbarrow into apartment
You can't see any such thing.

>push wheelbarrow
Nothing obvious happens.

>push
What do you want to push?

>push wheelbarrow
Nothing obvious happens.

>pull wheelbarrow
Nothing obvious happens.

>move wheelbarrow
Nothing obvious happens.

>move wheelbarrow to apartment
You can't see any such thing.

>push wheelbarrow to apartment
You can't see any such thing.

* * *

>test uptodock
(Testing.)

>[1] test pack
(Testing.)

>[2] get pack
You already have that.

>[3] test apt
(Testing.)

>[4] x fridge
You can't see any such thing.

>[5] open fridge
You can't see any such thing.

>[6] x bottle
You can't see any such thing.

>[7] open bottle
You can't see any such thing.

>[8] x dankdrinke
You can't see any such thing.

>[9] drink dankdrinke
You can't see any such thing.

>[10] x sheets
You can't see any such thing.

>[11] x panties
Pink and frilly. You should probably return those.

>[12] x rug
You can't see any such thing.

>[13] take panties
You already have that.

The C-Train departs without you.

>[14] take banana tree
You already have that.

>[15] test leave
(Testing.)

>[16] go south

IIT Campus
The campus is pretty sleepy in the summer. A construction crew works below the bell tower, but the only student you see is Ana.

You can see Ana and a stone bench here.

>[17] test vendor
(Testing.)

>[18] buy pile
You can't see any such thing.

>[19] buy mound
That doesn't cost any money.
You already have that.

>[20] test bird-a
(Testing.)

>[21] e
You can't go that way.

>[22] feed pile to bird
You can't see any such thing.

>test pack
(Testing.)

>[1] get pack
You already have that.

>get pack
You already have that.

>test apt
(Testing.)

>[1] x fridge
You can't see any such thing.

>[2] open fridge
You can't see any such thing.

>[3] x bottle
You can't see any such thing.

>[4] open bottle
You can't see any such thing.

>[5] x dankdrinke
You can't see any such thing.

>[6] drink dankdrinke
You can't see any such thing.

>[7] x sheets
You can't see any such thing.

>[8] x panties
Pink and frilly. You should probably return those.

>[9] x rug
You can't see any such thing.

>[10] take panties
You already have that.

>[11] take banana tree
You already have that.

>x fridge
You can't see any such thing.

>open fridge
You can't see any such thing.

>x bottle
You can't see any such thing.

>open bottle
You can't see any such thing.

>x dankdrinke
You can't see any such thing.

>drink dankdrinke
You can't see any such thing.

>x sheets
You can't see any such thing.

>x panties
Pink and frilly. You should probably return those.

>x rug
You can't see any such thing.

>take panties
You already have that.

>take banana tree
You already have that.

>test leave
(Testing.)

>[1] go south
You can't go that way.

>go south
You can't go that way.

>test vendor
(Testing.)

>[1] buy pile
You can't see any such thing.

>[2] buy mound
That doesn't cost any money.
You already have that.

>buy pile
You can't see any such thing.

>buy mound
That doesn't cost any money.
You already have that.

>test bird-a
(Testing.)

>[1] e
You can't go that way.

>[2] feed pile to bird
You can't see any such thing.

>e
You can't go that way.

>feed pile to bird
You can't see any such thing.

>w
You can't go that way.

>w
You can't go that way.

>test wait-a
(Testing.)

>[1] take kroner
You can't see any such thing.

>[2] r
Time passes.

>[3] r
Time passes.

>[4] r
Time passes.

>[5] r
Time passes.

>[6] r
Time passes.

>[7] r
Time passes.

>take kroner
You can't see any such thing.

>r
Time passes.

>r
Time passes.

>test trainto
(Testing.)

>[1] enter train
You can't see any such thing.

>[2] r
Time passes.

>[3] r
Time passes.

>[4] r
Time passes.

>[5] r
Time passes.

>[6] r
Time passes.

>[7] r
Time passes.

>[8] r
Time passes.

>[9] r
Time passes.

>[10] r
Time passes.

>enter train
You can't see any such thing.

>r
Time passes.

>exit
But you aren't in anything at the moment.

>w
You can't go that way.

>take flower
You can't see any such thing.

>take flower.
You can't see any such thing.

>tkae flower
That's not a verb I recognize.

* * *

>w
Aarenhus Cemetery
Dark paths run here and there among the marble tombs. Some trees provide relaxing shade, and white flowers bloom here and there.

You can see the friendly bird and several flowers here.

>take flower
You pluck a flower from where it grows.

>take flower.
You pluck a flower from where it grows.

>tkae flower
That's not a verb I recognize.

>i
You are carrying:
  two flowers
  a mound of herring
  a dwarf banana tree
  a pair of Central European panties
  a backpack (open)
    a wallet
      3 kroner
      1 Uncle Sam

>take flower
You pluck a flower from where it grows.

>i
You are carrying:
  three flowers
  a mound of herring
  a dwarf banana tree
  a pair of Central European panties
  a backpack (open)
    a wallet
      3 kroner
      1 Uncle Sam

>take flower
You pluck a flower from where it grows.

>i
You are carrying:
  four flowers
  a mound of herring
  a dwarf banana tree
  a pair of Central European panties
  a backpack (open)
    a wallet
      3 kroner
      1 Uncle Sam

>take flower
You pluck a flower from where it grows.

>take flower
You pluck a flower from where it grows.

>i
You are carrying:
  eight flowers
  a mound of herring
  a dwarf banana tree
  a pair of Central European panties
  a backpack (open)
    a wallet
      3 kroner
      1 Uncle Sam

>take flower
You pluck a flower from where it grows.

>i
You are carrying:
  ten flowers
  a mound of herring
  a dwarf banana tree
  a pair of Central European panties
  a backpack (open)
    a wallet
      3 kroner
      1 Uncle Sam

>take flower
You've already picked all the good ones.

>l
Aarenhus Cemetery
Dark paths run here and there among the marble tombs. Some trees provide relaxing shade, and white flowers bloom here and there.

You can see the friendly bird here.

>take bird
You can't take a person!

>l bird
The bird seems to have regained some energy after eating pile of herring. Its plumage has a healthy sheen.

* * *

I beg your pardon?

>gonea rsofa
That's not a verb I recognize.

>gonear paper kroner
Train Platform
The open-air train platform has a line that runs to Copenhagen every 10 minutes. There are no tickets: it is free to ride.

You can see a paper kroner here.

>take kroner
(the paper kroner)
You gain 1 kroner.

>r
Time passes.

>r
Time passes.

The C-Train arrives.

>enter train
You get into the C-Train.

In the C-Train you can see a wrap-around sofa.

>x train
This train is a large glass lozenge containing one big wrap-around sofa.

In the C-Train is a wrap-around sofa.

>x sofa
Made of plush leather for discerning Danish derrieres.

>r
Time passes.

>r
Time passes.

The C-Train departs, taking you into a tunnel.

I beg your pardon?

>l
Train Tunnel (in the C-Train)
This underwater transit tunnel represents a feat of engineering. Its creator won the Most Illustrious Dane medal.

In the C-Train you can see a wrap-around sofa.

>x tunnel
You can't see any such thing.

>restart
Are you sure you want to restart?

>y
Limbo has no description.
wallet has no description.
5 kroner has no description.
1 Uncle Sam has no description.
frying pan has no description.
shelves has no description.
row houses has no description.
pocket has no description.
fistful of herring has no description.
herring crate has no description.
rope has no description.
paper kroner has no description.
fake tree has no description.
pusher has no description.
gnarled bush has no description.

It is the Year of Our Lord MMXVIII. You have arrived in the Danish city of Copenhagen to pursue a master's degree. You found an apartment for let in the suburb of Hellerup, and promptly moved in. The place isn't much, but for the next two years it's home. 

PREPARE YOUR SPIRIT FOR . . .

RYAN QUEST 2
An Interactive Fiction by Maxwell Joslyn
Release 1 / Serial number 181125 / Inform 7 build 6M62 (I6/v6.33 lib 6/12N) SD

Apartment
Your apartment is a cheery little box. On the east wall is a round window. A woven rug adorns the floor in the middle of the room. Along the west wall are a fridge and some shelves. A bed lies in the northwest corner, and a stove lies in the northeast.

On the stove is a frying pan.

On the shelves is a loaf of bread.

You can also see an apartment door, a backpack (empty), a dwarf banana tree, a fridge (closed) and the bed (on which are bedsheets and a pair of Central European panties) here.

I beg your pardon?

>gonear paper kroner
Train Platform
The open-air train platform has a line that runs to Copenhagen every 10 minutes. There are no tickets: it is free to ride.

You can see a paper kroner here.

* * *

>r
Time passes.

I beg your pardon?

>r
Time passes.

* * *

I beg your pardon?

>r
Time passes.

The C-Train arrives.

* * *

>enter train
You get into the C-Train.

In the C-Train you can see a wrap-around sofa.

>r
Time passes.

* * *

>r
Time passes.

The C-Train departs, taking you into a tunnel.

>r
Time passes.

>wait
Time passes.

* * *

I beg your pardon?

>gonear joint
Christiana Main Street
This street is lined with drug pushers, filled with tourists, dotted with hippies, and sprinkled with musicians.

You can see a pusher here.

The pusher eyes your wallet.

>buy joint
You pay 2 kroner for the marijuana joint, leaving yourself with 3 kroner.

The pusher eyes your marijuana joint.

* * *

I beg your pardon?

>gonear marijuana
Christiana Main Street
This street is lined with drug pushers, filled with tourists, dotted with hippies, and sprinkled with musicians.

You can see a pusher and a pushcart (on which is a marijuana joint) here.

The pusher eyes your wallet.

>buy joit
You can't see any such thing.

>buy joint
You pay 2 kroner for the marijuana joint, leaving yourself with 3 kroner.

The pusher eyes your marijuana joint.

>x joint
This is the premium shit right here.

The pusher eyes your wallet.

>eat joint
That's definitely not edible.

The pusher eyes your wallet.

>smoke joint
You hit it and don't quit it. Your War-on-Drugs work ethic erases that joint from existence.

Now you're baked.

The pusher eyes your wallet.

* * *

>gonear paper kroner
Train Platform
The open-air train platform has a line that runs to Copenhagen every 10 minutes. There are no tickets: it is free to ride.

You can see a paper kroner here.

>rr
That's not a verb I recognize.

>r. r.
Time passes.

Time passes.

>r
Time passes.

* * *

>r
Time passes.

The C-Train arrives.

>board c-train
You get into the C-Train.

In the C-Train you can see a wrap-around sofa.

>exit
Train Platform
The open-air train platform has a line that runs to Copenhagen every 10 minutes. There are no tickets: it is free to ride.

You can see a C-Train (in which is a wrap-around sofa) and a paper kroner here.

>ride c-train
The C-Train cannot be ridden.

* * *

>cook dnkdri
You can't see any such thing.

I beg your pardon?

>open fridge
You open the fridge, revealing a piece of cheese, a steak and a glass bottle of Dankdrinke.

>test pack
(Testing.)

>[1] get pack
Taken.

>take all
dwarf banana tree: Taken.
frying pan: (putting the wallet into the backpack to make room)
Taken.
loaf of bread: (putting the dwarf banana tree into the backpack to make room)
Taken.
piece of cheese: (putting the frying pan into the backpack to make room)
Taken.
steak: (putting the loaf of bread into the backpack to make room)
Taken.
glass bottle of Dankdrinke: (putting the piece of cheese into the backpack to make room)
Taken.
bedsheets: (putting the steak into the backpack to make room)
Taken.
pair of Central European panties: (putting the glass bottle of Dankdrinke into the backpack to make room)
Nice.

>x bottle
No drinke is more ergonomik than Dankdrinke!

>eat dankdrinke
(first taking the glass bottle of Dankdrinke)
(putting bedsheets into the backpack to make room)
Your throat is filled with ergonomitivity.

[Your score has just gone up by one point.]

>restart
Are you sure you want to restart?

>y
herring crate has no description.
button has no description.
gray robe has no description.

It is the Year of Our Lord MMXVIII. You have arrived in the Danish city of Copenhagen to pursue a master's degree. You found an apartment for let in the suburb of Hellerup, and promptly moved in. The place isn't much, but for the next two years it's home. 

PREPARE YOUR SPIRIT FOR . . .

RYAN QUEST 2
An Interactive Fiction by Maxwell Joslyn
Release 1 / Serial number 181222 / Inform 7 build 6M62 (I6/v6.33 lib 6/12N) SD

Apartment
Your apartment is a cheery little cube. On the east wall is a round window. A woven rug adorns the floor in the middle of the room. Along the west wall are a fridge and some shelves. A bed lies in the northwest corner, and a stove lies in the northeast.

On the stove is a frying pan.

On the shelves is a loaf of bread.

You can also see an apartment door, a backpack (empty), a dwarf banana tree, a fridge (closed) and the bed (on which are bedsheets and a pair of Central European panties) here.

>test pack
(Testing.)

>[1] get pack
Taken.

>test apt
(Testing.)

>[1] x fridge
Silver, yet subtle. The handle is quite affordant.

>[2] open fridge
You open the fridge, revealing a piece of cheese, a steak and a glass bottle of Dankdrinke.

>[3] x bottle
No drinke is more ergonomik than Dankdrinke!

>[4] open bottle
It isn't something you can open.

>[5] x dankdrinke
No drinke is more ergonomik than Dankdrinke!

>[6] drink dankdrinke
It isn't something you can open.

(first taking the glass bottle of Dankdrinke)
Your throat is filled with ergonomitivity.

[Your score has just gone up by one point.]

>[7] x sheets
Extremely rumpled from excessive romping.

>[8] x panties
Pink, frilly, and definitely not yours.

>[9] x rug
The rug depicts a scene of universal healthcare flying over a lake.

>[10] take panties
Nice.

>[11] take banana tree
(putting the wallet into the backpack to make room)
Taken.

I beg your pardon?

>go south
(first opening the apartment door)

Hellerup Strandvejen
The main street of Hellerup is bordered on its north side by brightly-painted row houses, such as the one containing your apartment. At the east end is a dock, and if you go west you can catch a train.

You can see an apartment door, a street vendor and a wheelbarrow (in which are a pile of herring and a mound of herring) here.

The vendor calls out, "Today I have a pile of herring and a mound of herring! Fresh!"

>test vendor
(Testing.)

>[1] buy pile
You pay 1 kroner for the pile of herring, leaving yourself with 4 kroner.

The vendor calls out, "Today I have a mound of herring! Fresh!"

>[2] buy mound
You pay 2 kroner for the mound of herring, leaving yourself with 2 kroner.

The vendor grins cheerfully.

>test bird-a
(Testing.)

>[1] e

Dock
This is a shabby little dock used for the fishing trade. At the end of the dock, a little rowboat, moored with a rope, bobs up and down. In the rowboat is a large crate, atop which sits a bird.

>[2] feed pile to bird
The wretched bird regards you warily, then opens its beak and snaps up the pile of herring. It swallows in one gulp.

You see a flash of brilliance in its black, beady eyes. Then it caws, and flies off in the direction of Copenhagen.

You feel strangely proud.

[Your score has just gone up by one point.]

>test docktoplatform
(Testing.)

>[1] w

Hellerup Strandvejen
The main street of Hellerup is bordered on its north side by brightly-painted row houses, such as the one containing your apartment. At the east end is a dock, and if you go west you can catch a train.

You can see an apartment door, a street vendor and a wheelbarrow (empty) here.

>[2] w

Train Platform
The open-air train platform has a line that runs to Copenhagen every 10 minutes. There are no tickets: it is free to ride.

You can see a wall sign and a paper kroner here.

>x sign
It reads, "PLEASE WAIT FOR TRAIN".

>w
You can't go that way.

>e
Hellerup Strandvejen
The main street of Hellerup is bordered on its north side by brightly-painted row houses, such as the one containing your apartment. At the east end is a dock, and if you go west you can catch a train.

You can see an apartment door, a street vendor and a wheelbarrow (empty) here.

The vendor taps his foot.

>r
Time passes.

>e
Dock
This is a shabby little dock used for the fishing trade. At the end of the dock, a little rowboat, moored with a rope, bobs up and down. In the rowboat is a large crate, atop which sits a bird.

>r
Time passes.

>w
Hellerup Strandvejen
The main street of Hellerup is bordered on its north side by brightly-painted row houses, such as the one containing your apartment. At the east end is a dock, and if you go west you can catch a train.

You can see an apartment door, a street vendor and a wheelbarrow (empty) here.

>w
Train Platform
The open-air train platform has a line that runs to Copenhagen every 10 minutes. There are no tickets: it is free to ride.

You can see a C-Train (in which is a wrap-around sofa), a wall sign and a paper kroner here.

>enter train
You get into the C-Train.

In the C-Train you can see a wrap-around sofa.

>take kroner
(the paper kroner)
You gain 1 kroner.

The C-Train departs, taking you into a tunnel.

>l
Train Tunnel (in the C-Train)
This underwater transit tunnel represents a feat of engineering. Its creator won the Most Illustrious Dane medal.

In the C-Train you can see a wrap-around sofa.

You arrive in Copenhagen.

>exit
Copenhagen Metro Station
This is the main metro station in Copenhagen. Its creator won the Best Dane of the Year Award.

Stairs lead southward and upward to the IIT Campus exit. Christiana is northwest of here: this much you know.

The Danes are very efficient: you can also take a direct route west from here to the Aarenhus Cemetery.

A small door stands in the southeast corner of the station near a fake tree.

You can see a C-Train (in which is a wrap-around sofa) and the fake tree here.

>w
Aarenhus Cemetery
Dark paths run here and there among the marble tombs. Some trees provide relaxing shade, and flowers bloom here and there.

You can see the friendly bird, a red flower, a white flower, a blue flower and a yellow flower here.

>take all
red flower: (putting the pair of Central European panties into the backpack to make room)
You're carrying too many things already.
white flower: (putting the dwarf banana tree into the backpack to make room)
Taken.
blue flower: (putting the mound of herring into the backpack to make room)
Taken.
yellow flower: (putting the white flower into the backpack to make room)
Taken.

>x bird
The bird seems to have regained some energy after eating. Its plumage has a healthy sheen.

>feed bird
What do you want to feed the friendly bird to?

I beg your pardon?

>feed herring to bird
(first taking the mound of herring)
(putting the blue flower into the backpack to make room)
The friendly bird nuzzles your hand, then gently spears the mound of herring with its beak. It jerks its head, tossing the mound of herring into the air, then leaps into the air to grab it.

It circles lazily above you for a minute or two, then soars off elsewhere.

[Your score has just gone up by one point.]

>e
Copenhagen Metro Station
This is the main metro station in Copenhagen. Its creator won the Best Dane of the Year Award.

Stairs lead southward and upward to the IIT Campus exit. Christiana is northwest of here: this much you know.

The Danes are very efficient: you can also take a direct route west from here to the Aarenhus Cemetery.

A small door stands in the southeast corner of the station near a fake tree.

You can see the fake tree here.

>n
You can't go that way.

>ne
You can't go that way.

>up
IIT Campus
The campus is pretty sleepy in the summer. A construction crew works below the bell tower, but the only student you see is Ana.

You can see Ana and a stone bench here.

>x ana
A Czech girl. Starting next week, she's your TA for Introductory Programming. Starting last night, she's your lover.

>touch ana
She slaps your hand away.

>kiss aa
You can't see any such thing.

>kiss ana
She slaps the kiss right off your lips.

>give ana a flower
(the yellow flower)
Ana sighs and kisses your cheek. She strolls over to the bench, and sits down to gaze at the flower.

[Your score has just gone up by one point.]

>kiss aa
You can't see any such thing.

>kiss aa
You can't see any such thing.

>kiss ana
You plant your soft lips on her cheek, and she squeals in delight.

>give ana panties
(first taking the pair of Central European panties)
She blushes, snatches the pair of Central European panties, and flounces off.

[Your score has just gone up by one point.]

>l
IIT Campus
The campus is pretty sleepy in the summer. A construction crew works below the bell tower, but no students are to be seen.

You can see a stone bench here.

>l ana
You can't see any such thing.

>x bech
You can't see any such thing.

>sit on bench
You get onto the stone bench.

>x bench
Effortlessly square.

On the base, nearly invisible, is an unlabelled beige button.

>touch button
You feel nothing unexpected.

>press button
From somewhere nearby, a voice yells, "F!"

>g
From somewhere nearby, a voice yells, "E!"

>g
From somewhere nearby, a voice yells, "E!"

>g
From somewhere nearby, a voice yells, "D!"

>g
From somewhere nearby, a voice yells, "B!"

>g
From somewhere nearby, a voice yells, "I!"

>g
From somewhere nearby, a voice yells, "R!"

I beg your pardon?

>g
From somewhere nearby, a voice yells, "D!"

>g
Nothing appears to happen.
;-)
[Your score has just gone up by one point.]

* * *

>cook steak
You can't see any such thing.

>open fridge. take steak
You open the fridge, revealing a piece of cheese, a steak and a glass bottle.

Taken.

>cook teak
You can't see any such thing.

>eat steak
That's definitely not edible.

>cook steak
You cook the steak, filling the air with delicious smells.

[Your score has just gone up by one point.]

>eat steak
That's definitely not edible.

* * *

>dirs
Ordinary exits are to the south.

>gonear metro
Copenhagen Metro Station
This is the main metro station in Copenhagen. Its creator won the Best Dane of the Year Award.

Stairs lead southward and upward to the IIT Campus exit. Christiana is northwest of here: this much you know.

The Danes are very efficient: you can also take a direct route west from here to the Aarenhus Cemetery.

A small door stands in the southeast corner of the station near a fake tree.

You can see the fake tree here.

>exits
That's not a verb I recognize.

>dirs
Ordinary exits are to the northwest, the south, the southeast, the west, the up and the inside.

>inside
You walk up to the fake tree. Your instincts propel you onward, and you walk into the tree.

You're inside the tree, Ryan.

You're not a ghost yet, so you still can't walk through trees.

* * *

>eat bread
(first taking the loaf of bread)
You eat the loaf of bread. Not bad.

>pick up rug
You couldn't possibly take that! It belongs to your landlady.

>pick banana
I didn't understand that sentence.

* * *

>i
You are carrying:
  a dwarf banana tree
  a wallet
    5 kroner
    1 Uncle Sam

>leave apartment
I only understood you as far as wanting to leave.

>open window
It isn't something you can open.

>break window
Violence isn't the answer to this one.

>check email
You can't see any such thing.

>check door
Just looking at this door makes you eager to start each day.

>start day
That's not a verb I recognize.

>exit apartment
I only understood you as far as wanting to exit.

>exit door
I only understood you as far as wanting to exit.

>go south
(first opening the apartment door)
You can't go to school without your backpack.

>take backpack
Taken.

>go south
(first opening the apartment door)

Hellerup Strandvejen
The main street of Hellerup is bordered on its north side by brightly-painted row houses, such as the one containing your apartment. At the east end is a dock, and if you go west you can catch a train.

You can see an apartment door, a street vendor and a wheelbarrow (in which are a pile of herring and a mound of herring) here.

>ivestigate wheelbarrow
That's not a verb I recognize.

>x wheelbarrow
Rusty but serviceable. It contains a pile of herring and a mound of herring.

In the wheelbarrow are a pile of herring and a mound of herring.

>eat herring
Which do you mean, the fistful of herring, the pile of herring or the mound of herring?

>mound
(first taking the mound of herring)
That costs money.

>buy mound of herring
You pay 2 kroner for the mound of herring, leaving yourself with 3 kroner.

The vendor calls out, "Today I have a pile of herring! Fresh!"

>buy pile
You pay 1 kroner for the pile of herring, leaving yourself with 2 kroner.

>buy fistful
That doesn't cost any money.
That seems to belong to the street vendor.

>go east
Dock
This is a shabby little dock used for the fishing trade. At the end of the dock, a little rowboat, moored with a rope, bobs up and down. In the rowboat is a large crate, atop which sits a bird.

>trap bird with herring
That's not a verb I recognize.

>bait bird with herring
That's not a verb I recognize.

>catch bird
That's not a verb I recognize.

>kill bird
Violence isn't the answer to this one.

>seduce bird
That's not a verb I recognize.

>x bird
The species is impossible to identify, but its plumage is wilted, its beak is crooked, and its eyes are dull.

>kiss bird
The wretched bird might not like that.

>grab bird
That's not a verb I recognize.

>take bird
You can't take a living thing!

>release bird
That's not a verb I recognize.

>fish
That's not a verb I recognize.

>get in rowboat
It's much too slippery for a landlubber like you to get in.

>buy boots
You can't see any such thing.

>take rope
That's hardly portable.

>trade bird
That's not a verb I recognize.

>x crate
On the herring crate is a wretched bird.

>x crate
On the herring crate is a wretched bird.

>lure bird
That's not a verb I recognize.

>trap bird
That's not a verb I recognize.

>scare bird
That's not a verb I recognize.

>hit bird
Violence isn't the answer to this one.

>charm bird
That's not a verb I recognize.

>give bird pile of herring
The wretched bird does not desire a pile of herring.

>give bird one herring
(the pile of herring)
The wretched bird does not desire a pile of herring.

>give bird a mound of herring
The wretched bird does not desire a mound of herring.

>give bird a fist full of herring
You can't see any such thing.

>feed bird herring
I didn't understand that sentence.

>feed herring to bird
Which do you mean, the herring crate, the pile of herring or the mound of herring?

>crate
(first taking the herring crate)
That's fixed in place.

>pile
That's not a verb I recognize.

>feed herring to bird
Which do you mean, the herring crate, the pile of herring or the mound of herring?

>pile
The wretched bird regards you warily, then opens its beak and snaps up the pile of herring. It swallows in one gulp.

You see a flash of brilliance in its black, beady eyes. Then it caws, and flies off in the direction of Copenhagen.

You feel strangely proud.

[Your score has just gone up by one point.]

>i
You are carrying:
  a mound of herring
  a backpack (open but empty)
  a dwarf banana tree
  a wallet
    2 kroner
    1 Uncle Sam

>go west
Hellerup Strandvejen
The main street of Hellerup is bordered on its north side by brightly-painted row houses, such as the one containing your apartment. At the east end is a dock, and if you go west you can catch a train.

You can see an apartment door, a street vendor and a wheelbarrow (empty) here.

>talk to vendor
That's not a verb I recognize.

>spreak with vendor
That's not a verb I recognize.

>kiss vendor
The street vendor might not like that.

The vendor grins cheerfully.

>tongue kiss vendor
That's not a verb I recognize.

>lick vendor
That's not a verb I recognize.

>rob vendor
That's not a verb I recognize.

>x  vendor
A friendly purveyor of herring, and perhaps more. He wears a long coat, a fingerless glove, a pair of trousers and a pair of sneakers.

The vendor taps his foot.

>tap foot
That's not a verb I recognize.

>dance
That's not a verb I recognize.

>the ryan dance
That's not a verb I recognize.

>go west
Train Platform
The open-air train platform has a line that runs to Copenhagen every 10 minutes. There are no tickets: just line up and wait for the next train to come.

You can see a paper kroner here.

>take kroner
You gain 1 kroner.

>take kroner
You can't see any such thing.

>get in line
You can't see any such thing.

>board train
That's not a verb I recognize.

>wait 10 minutes
I only understood you as far as wanting to wait.

>wait for train
I only understood you as far as wanting to wait.

>wait
Time passes.

>board train
That's not a verb I recognize.

>sit on floor
You can't see any such thing.

>sit on ench
You can't see any such thing.

>talk to stranger
That's not a verb I recognize.

>sit on bench
You can't see any such thing.

>stand on tracks
You can't see any such thing.

>look around
You can't see any such thing.

>x train station
You can't see any such thing.

>wait
Time passes.

>r
Time passes.

* * *

>r
Time passes.

The C-Train arrives.

>x traib
You can't see any such thing.

>enter
You get into the C-Train.

>l
Train Platform (in the C-Train)
The open-air train platform has a line that runs to Copenhagen every 10 minutes. There are no tickets: just line up and wait for the next train to come.

>wait
Time passes.

>wait
Time passes.

>wait
Time passes.

The C-Train departs, taking you into a tunnel.

>x
What do you want to examine?

>x tunnel
You can't see any such thing.

>x train
This train is made of 7 round glass pods. Each pod contains a sofa.

>go to bar
You can't see any such thing.

>explore train
That's not a verb I recognize.

>wait
Time passes.

>wait
Time passes.

You arrive in Copenhagen.

>exit train
I only understood you as far as wanting to exit.

>exit
Copenhagen Metro Station
This is the main metro station in Copenhagen. Its creator won the Best Dane of the Year Award.

Stairs lead southward and upward to the IIT Campus exit. Christiana is northwest of here: this much you know.

The Danes are very efficient: you can also take a direct route west from here to the Aarenhus Cemetery.

A small door stands in the southeast corner of the station near a fake tree.

You can see a C-Train (empty) and the fake tree (closed) here.

>x fake tree
You see nothing special about the fake tree.

>open fake tree
To your surprise, this tree is actually a door!

It seems to be locked.

>pick lock
I didn't understand that sentence.

>go to christiana
You can't see any such thing.

>go northwest
Christiana Main Street
This street is lined with drug pushers, filled with tourists, dotted with hippies, and sprinkled with musicians.

You can see a pusher here.

The pusher eyes your backpack.

>buy drugs
You can't see any such thing.

>talk to pusher
That's not a verb I recognize.

>approach pusher
That's not a verb I recognize.

>x pusher
You see nothing special about the pusher.

The pusher eyes your wallet.

>feed pusher herring
I didn't understand that sentence.

>attack pusher
Violence isn't the answer to this one.

The pusher eyes your backpack.

>open backpack
That's already open.

The pusher eyes your backpack.

>give wallet to pusher
The pusher does not desire a wallet.

The pusher eyes your mound of herring.

>give pusher mound of herring
The pusher does not desire a mound of herring.

The pusher eyes your dwarf banana tree.

>give pusher dwarf banana tree
The pusher does not desire a dwarf banana tree.

The pusher eyes your backpack.

>kiss pusher
The pusher might not like that.

The pusher eyes your dwarf banana tree.

>talk to pusher
That's not a verb I recognize.

>i
You are carrying:
  a mound of herring
  a backpack (open but empty)
  a dwarf banana tree
  a wallet
    3 kroner
    1 Uncle Sam

The pusher eyes your dwarf banana tree.

>give pusher uncle sam
The pusher does not desire 1 Uncle Sam.

The pusher eyes your dwarf banana tree.

>give pusher 3 kroner
You can't use multiple objects with that verb.

>give pusher kroner
You can't see any such thing.

>go east
You can't go that way.

The pusher eyes your wallet.

>open wallet
It isn't something you can open.

The pusher eyes your backpack.

>wait
Time passes.

The pusher eyes your dwarf banana tree.

>wait
Time passes.

The pusher eyes your dwarf banana tree.

>wait
Time passes.

The pusher eyes your mound of herring.

>wait
Time passes.

The pusher eyes your mound of herring.

>wait
Time passes.

The pusher eyes your dwarf banana tree.

>wait
Time passes.

The pusher eyes your wallet.

>wait
Time passes.

The pusher eyes your wallet.

>go west
You can't go that way.

The pusher eyes your dwarf banana tree.

>go nw
You can't go that way.

The pusher eyes your dwarf banana tree.

>go n
You can't go that way.

The pusher eyes your backpack.

>n
You can't go that way.

The pusher eyes your dwarf banana tree.

>ne
You can't go that way.

The pusher eyes your backpack.

>e
You can't go that way.

The pusher eyes your dwarf banana tree.

>s
You can't go that way.

The pusher eyes your wallet.

>sw
You can't go that way.

The pusher eyes your mound of herring.

>se
Copenhagen Metro Station
This is the main metro station in Copenhagen. Its creator won the Best Dane of the Year Award.

Stairs lead southward and upward to the IIT Campus exit. Christiana is northwest of here: this much you know.

The Danes are very efficient: you can also take a direct route west from here to the Aarenhus Cemetery.

A small door stands in the southeast corner of the station near a fake tree.

You can see the fake tree (closed) here.

>west
Aarenhus Cemetery
Dark paths run here and there among the marble tombs. Some trees provide relaxing shade, and white flowers bloom here and there.

You can see the friendly bird and several flowers here.

>pick flowers
I didn't understand that sentence.

>take flower
You pluck a flower from where it grows.

>x bird
The bird seems to have regained some energy after eating. Its plumage has a healthy sheen.

>call bird
That's not a verb I recognize.

>take bird
You can't take a living thing!

>give bird herring
The friendly bird does not desire a mound of herring.

>feed bird
What do you want to feed the friendly bird to?

>me
(first taking the friendly bird)
You can't take a living thing!

>pusher
That's not a verb I recognize.

>tombs
That's not a verb I recognize.

>feed herring to bird
*** Run-time problem P54: Tried to move The Path (not a thing) to the gnarled bush, but only things can move around.

The friendly bird nuzzles your hand, then gently spears the mound of herring with its beak. It jerks its head, tossing the mound of herring into the air, then leaps into the air to grab it.

It circles lazily above you for a minute or two, then soars off elsewhere.

[Your score has just gone up by one point.]

>dig grave
That's not a verb I recognize.

>x grave
You can't see any such thing.

>grave rob
That's not a verb I recognize.

>x
What do you want to examine?

>x graveyard
You can't see any such thing.

>x location
You can't see any such thing.

>x graveyard
You can't see any such thing.

>x Aarenhus Cemetery
You can't see any such thing.

>l
Aarenhus Cemetery
Dark paths run here and there among the marble tombs. Some trees provide relaxing shade, and white flowers bloom here and there.

You can see several flowers here.

>x tombs
You see nothing special about the marble tombs.

>l tombs
You see nothing special about the marble tombs.

>x trees
You see nothing special about the trees.

>x path
You can't see any such thing.

>walk on path
You can't see any such thing.

>take path
You can't see any such thing.

>x flowers
You can't use multiple objects with that verb.

>x flower
Sweet-smelling.

>e
Copenhagen Metro Station
This is the main metro station in Copenhagen. Its creator won the Best Dane of the Year Award.

Stairs lead southward and upward to the IIT Campus exit. Christiana is northwest of here: this much you know.

The Danes are very efficient: you can also take a direct route west from here to the Aarenhus Cemetery.

A small door stands in the southeast corner of the station near a fake tree.

You can see a C-Train (empty) and the fake tree (closed) here.

The C-Train departs without you.

>sw
You can't go that way.

>take stairs
You can't see any such thing.

>s
IIT Campus
The campus is pretty sleepy in the summer. A construction crew works below the bell tower, but the only student you see is Ana.

You can see Ana and a stone bench here.

>approach ana
That's not a verb I recognize.

>talk to ana
That's not a verb I recognize.

>l ana
A Czech girl. Starting next week, she's your TA for Introductory Programming. Starting last night, she's your lover.

>kiss ana
Ana might not like that.

>x ana
A Czech girl. Starting next week, she's your TA for Introductory Programming. Starting last night, she's your lover.

>l ana
A Czech girl. Starting next week, she's your TA for Introductory Programming. Starting last night, she's your lover.

>talk to ana
That's not a verb I recognize.

>feed ana
What do you want to feed Ana to?

>mound of herring
You can't see any such thing.

>dwarf banana tree
That's not a verb I recognize.

>touch ana
Ana might not like that.

>do it
That's not a verb I recognize.

>avoid ana
That's not a verb I recognize.

>sit on bench
That's not something you can sit down on.

>lay on bench
That's not a verb I recognize.

>x bench
Effortlessly square.

>sit
What do you want to sit on?

>bench
That's not something you can sit down on.

>sit
What do you want to sit on?

>ana
She's not something you can sit down on.

>ask ana to sit on face
I didn't understand that sentence.

>h
That's not a verb I recognize.

>help
Good fortune awaits you if you use these keys:
look - l - Describes the room you're in and what you perceive there.
examine - x - Looks at a person or thing more closely to gain information.
take - take - Picks something up to take with you.
inventory - i - Checks the items you're carrying with you.
wait - r (for rest) - Waits/rests for one turn.
banter - banter - Just bloody try it bruv I swear on me grave
In general, examine everything for clues and take anything you can. Good luck!

>banter ana
That's not a verb I recognize.

>banter
That's not a verb I recognize.

>take ana
Ana is incensed. "Trying to take me in in public?! What would your glorious Lincoln think of that?"

>he died for this
That's not a verb I recognize.

>pursist
That's not a verb I recognize.

>pursue
That's not a verb I recognize.

>seek and destroy
That's not a verb I recognize.

>kiss ana
Ana might not like that.

>i
You are carrying:
  a flower
  a backpack (open but empty)
  a dwarf banana tree
  a wallet
    3 kroner
    1 Uncle Sam

>give ana flower
Ana sighs and kisses your cheek. She strolls over to the bench, and sits down to gaze at the flower.

[Your score has just gone up by one point.]

>sit on bench
That's not something you can sit down on.

>go west
You can't go that way.

>go south
You can't go that way.

>s
You can't go that way.

>go n
Copenhagen Metro Station
This is the main metro station in Copenhagen. Its creator won the Best Dane of the Year Award.

Stairs lead southward and upward to the IIT Campus exit. Christiana is northwest of here: this much you know.

The Danes are very efficient: you can also take a direct route west from here to the Aarenhus Cemetery.

A small door stands in the southeast corner of the station near a fake tree.

You can see a C-Train (empty) and the fake tree (closed) here.

The C-Train departs without you.

>open tree
(the dwarf banana tree)
It isn't something you can open.

>x fake tree
You see nothing special about the fake tree.

>open fake tree
It seems to be locked.

>unlock fake tree
What do you want to unlock the fake tree with?

>key
You can't see any such thing.

>pcik
That's not a verb I recognize.

>pick
(up the fake tree)
(putting the wallet into the backpack to make room)
Taken.

>go west
Aarenhus Cemetery
Dark paths run here and there among the marble tombs. Some trees provide relaxing shade, and white flowers bloom here and there.

You can see several flowers here.

>open tomb
You can't see any such thing.

>x tomb
You can't see any such thing.

>x marble tombs
You see nothing special about the marble tombs.

>open marble tombs
They aren't something you can open.

>x trees
You see nothing special about the trees.

>go e
Copenhagen Metro Station
This is the main metro station in Copenhagen. Its creator won the Best Dane of the Year Award.

Stairs lead southward and upward to the IIT Campus exit. Christiana is northwest of here: this much you know.

The Danes are very efficient: you can also take a direct route west from here to the Aarenhus Cemetery.

A small door stands in the southeast corner of the station near a fake tree.

>go to small door
You can't see any such thing.

>x small door
It's not even a finished door - just a plank of wood on hinges. A sign hangs from a nail in the middle.

>open door
You open the small door.

>enter small door
The Path
This odd little path runs out of the metro station and toward an isolated hill overlooking the bay. The ground is grassy, but the only larger vegetation is a gnarled bush.

You can see the friendly bird here.

>give bird fake tree
The friendly bird does not desire the fake tree.

>give bird kiss
You can't see any such thing.

* * *

>eat frying pan
That's definitely not edible.

>eat tre
You can't see any such thing.

>eat tree
That's definitely not edible.

>eat panties
That's definitely not edible.

>x panties
Pink and frilly. You should probably return those.

>take panties
Nice.

[Your score has just gone up by one point.]

>take fridge
That's fixed in place.

>x fridge
Silver, yet subtle. The handle is quite affordant..

>pull handle
You open the fridge, revealing a piece of cheese, a steak and a glass bottle.

>take cheese
Taken.

>take steak
(putting the pair of Central European panties into the backpack to make room)
Taken.

>take bottle
(putting the piece of cheese into the backpack to make room)
Taken.

>drink bottle
That's definitely not edible.

>x bottle
In the glass bottle is some Dankdrinke.

>x dankdrinke
No drinke is more ergonomik than Dankdrinke!

>drink dankdrinke
The glass bottle isn't open.

>eat dankdrinke
The glass bottle isn't open.

>open bottle
You open the glass bottle.

>drink dankdrinke
(first taking the Dankdrinke)
(putting the steak into the backpack to make room)
Your throat is filled with ergonomitivity.

[Your score has just gone up by one point.]

>i
You are carrying:
  a glass bottle (open but empty)
  a backpack (open)
    a steak
    a piece of cheese
    a pair of Central European panties

>stow bottle
That's not a verb I recognize.

>put bottle in backpack
You put the glass bottle into the backpack.

>i
You are carrying:
  a backpack (open)
    a glass bottle (open but empty)
    a steak
    a piece of cheese
    a pair of Central European panties

>get panties
Nice.

[Your score has just gone up by one point.]

>get panties
You already have that.

>take panties
You already have that.

>drop panties
Dropped.

>take panties
Nice.

[Your score has just gone up by one point.]

* * *

>eat panties
Foolish American, have you truly mistaken the pair of Central European panties for food?

>eat steak
You can't see any such thing.

>eat fridge
Stupid American, have you truly mistaken the fridge for food?

>pick up frige
You can't see any such thing.

>pick up fridge
That's fixed in place.

>pick up pck
You can't see any such thing.

>pick up backpack
You take the backpack.

>take reed
You can't see any such thing.

>x pack
Adorned with the seal of Reed College, your undergraduate alma mater.

>eat pack
Idiotic American, have you truly mistaken the backpack for food?

>touch ana
You can't see any such thing.

>s
(first opening the apartment door)

Hellerup Strandvejen
The main street of Hellerup is bordered on its north side by brightly-painted row houses, such as the one containing your apartment. At the east end is a dock, and if you go west you can catch a train.

You can see an apartment door, a street vendor and a wheelbarrow (in which are a pile of herring and a mound of herring) here.

>touch vendor
Mind your manners, ignorant American!

>lick vendor
That's not a verb I recognize.

>suckle vendor nips
That's not a verb I recognize.

>eat
What do you want to eat?

>herring
Which do you mean, the fistful of herring, the pile of herring or the mound of herring?

>pile
(first taking the pile of herring)
That costs money.

>buy money
The money belongs to you, and you buy things with it.

The vendor calls out, "Today I have a pile of herring and a mound of herring! Fresh!"

>buy herring
Which do you mean, the fistful of herring, the pile of herring or the mound of herring?

>pile
You pay 1 kroner for the pile of herring, leaving yourself with 4 kroner.

>eat herring
(the pile of herring)
You eat the pile of herring. Not bad.

* * *

>eat steak
You can't see any such thing.

>open fridge
You open the fridge, revealing a piece of cheese, a steak and a glass bottle.

>eat steak
Are you sure? You might need that later. [y/n]

>y
Foolish American, have you truly mistaken the steak for food?

* * *

>eat tree
Foolish American, have you truly mistaken the dwarf banana tree for food?

>actiions
That's not a verb I recognize.

>actions
Actions listing on.

>rules
Rules tracing now switched on. Type "rules off" to switch it off again, or "rules all" to include even rules which do not apply.

>eat tree
[Rule "declare everything initially unmentioned rule" applies.]
[eating the dwarf banana tree]
[Rule "announce items from multiple object lists rule" applies.]
[Rule "set pronouns from items from multiple object lists rule" applies.]
[Rule "before stage rule" applies.]
[Rule "sanity-check stage rule" applies.]
[Rule "Sanity-check eating an inedible thing" applies.]
That's definitely not edible.
[eating the dwarf banana tree - ended without result]

[Rule "A first turn sequence rule" applies.]
[Rule "every turn stage rule" applies.]
[Rule "A last turn sequence rule" applies.]
[Rule "notify score changes rule" applies.]

* * *

>eat tree
Foolish American, have you truly mistaken the dwarf banana tree for food?

>cook tree
Foolish American, have you truly mistaken the dwarf banana tree for food?

>cook steak
You can't see any such thing.

>open fridge
You open the fridge, revealing a piece of cheese, a steak and a glass bottle.

>pull handle
That's already open.

>close fridge
You close the fridge.

>push handle
Nothing obvious happens.

>pull handle
You open the fridge, revealing a piece of cheese, a steak and a glass bottle.

>push handle
Nothing obvious happens.

* * *

>enter bread
That's not something you can enter.

* * *

>fry bread
That's not a verb I recognize.

>put bread in backpack
(first taking the loaf of bread)
You put the loaf of bread into the backpack.

>put dwarf banana tree in backpack
(first taking the dwarf banana tree)
You put the dwarf banana tree into the backpack.

>open fridge
You open the fridge, revealing a piece of cheese, a steak and a glass bottle.

>put all in backpack
wallet: Done.

>i
You are carrying nothing.

>x pack
Adorned with the seal of Reed College, your undergraduate alma mater.

In the backpack are a wallet, a dwarf banana tree and a loaf of bread.

>put cheese in backpack. put steak in backpack.
(first taking the piece of cheese)
You put the piece of cheese into the backpack.

(first taking the steak)
You put the steak into the backpack.

>put backpack in fridge
(first taking the backpack)
You put the backpack into the fridge.

>sniff panties
You smell nothing unexpected.

>wear panties
(first taking the pair of Central European panties)
Nice.

You can't wear that!

>why not?
That's not a verb I recognize.

>put bedsheets in backpack
(first taking bedsheets)
You put bedsheets into the backpack.

>take backpack
Taken.

>open door
You open the apartment door.

>open window
It isn't something you can open.

>leave apartment
I only understood you as far as wanting to leave.

>go through door
Hellerup Strandvejen
The main street of Hellerup is bordered on its north side by brightly-painted row houses, such as the one containing your apartment. At the east end is a dock, and if you go west you can catch a train.

You can see an apartment door, a street vendor and a wheelbarrow (in which are a pile of herring and a mound of herring) here.

>talk to street vendor
That's not a verb I recognize.

>find jesus
That's not a verb I recognize.

>say jesus
(to the street vendor)
There is no reply.

>go to street vendor
You can't see any such thing.

>talk to street vendor
That's not a verb I recognize.

>speak with street vendor
(to the street vendor)
There is no reply.

The vendor calls out, "Today I have a pile of herring and a mound of herring! Fresh!"

>how much is the pile?
That's not a verb I recognize.

>Walk
You'll have to say which compass direction to go in.

>Go North
Apartment
Your apartment is a cheery little box. On the east wall is a round window. A woven rug adorns the floor in the middle of the room. Along the west wall are a fridge and some shelves. A bed lies in the northwest corner, and a stove lies in the northeast.

On the stove is a frying pan.

You can also see an apartment door, a fridge (in which is a glass bottle (closed) (in which is some Dankdrinke)) and the bed here.

>go through door
Hellerup Strandvejen
The main street of Hellerup is bordered on its north side by brightly-painted row houses, such as the one containing your apartment. At the east end is a dock, and if you go west you can catch a train.

You can see an apartment door, a street vendor and a wheelbarrow (in which are a pile of herring and a mound of herring) here.

>go South
You can't go that way.

>go West
Train Platform
The open-air train platform has a line that runs to Copenhagen every 10 minutes. There are no tickets: just line up and wait for the next train to come.

You can see a paper kroner here.

>eat paper Kroner
That's definitely not edible.

>pick up paper kroner
You gain 1 kroner.

The C-Train arrives.

>board C-Train
That's not a verb I recognize.

>enter C-Train
You get into the C-Train.

>sit down
I didn't understand that sentence.

>find chair
That's not a verb I recognize.

>look
Train Platform (in the C-Train)
The open-air train platform has a line that runs to Copenhagen every 10 minutes. There are no tickets: just line up and wait for the next train to come.

>look at C-Train
This train is made of 7 round glass pods. Each pod contains a sofa.

>sit on sofa
You can't see any such thing.

>go to sofa
You can't see any such thing.

>sit
What do you want to sit on?

>sit on ground
You can't see any such thing.

>sit on train
But you're already in the C-Train.

>put c-train in backpack
(first taking the C-Train)
You would have to get out of the C-Train first.

The C-Train departs, taking you into a tunnel.

>wait
Time passes.

* * *

>wait
Time passes.

You arrive in Copenhagen.

>get off train
But you aren't on the C-Train at the moment.

>put C-Train into backpack
(first taking the C-Train)
You would have to get out of the C-Train first.

>exit C-Train
I only understood you as far as wanting to exit.

>exit
Copenhagen Metro Station
This is the main metro station in Copenhagen. Its creator won the Best Dane of the Year Award.

Stairs lead southward and upward to the IIT Campus exit. Christiana is northwest of here: this much you know.

The Danes are very efficient: you can also take a direct route west from here to the Aarenhus Cemetery.

A small door stands in the southeast corner of the station near a fake tree.

You can see a C-Train (empty) and the fake tree (closed) here.

>put C-Train into backpack
(first taking the C-Train)
You put the C-Train into the backpack.

>go northwest
Christiana Main Street
This street is lined with drug pushers, filled with tourists, dotted with hippies, and sprinkled with musicians.

You can see a pusher here.

The pusher eyes your pair of Central European panties.

>flaunt panties
That's not a verb I recognize.

>put pusher into backpack
(first taking the pusher)
You can't take a living thing!

The pusher eyes your pair of Central European panties.

>"hey stranger"
That's not a verb I recognize.

>talk to pusher
That's not a verb I recognize.

>speak at pusher
(to the pusher)
There is no reply.

The pusher eyes your pair of Central European panties.

>speak pusher
(to the pusher)
There is no reply.

The pusher eyes your pair of Central European panties.

>look
Christiana Main Street
This street is lined with drug pushers, filled with tourists, dotted with hippies, and sprinkled with musicians.

You can see a pusher here.

The pusher eyes your pair of Central European panties.

>examine pusher
You see nothing special about the pusher.

The pusher eyes your backpack.

>examine panties
Pink and frilly. You should probably return those.

The pusher eyes your backpack.

>unleash C-Train upon pusher
That's not a verb I recognize.

>run northwest
You can't go that way.

The pusher eyes your pair of Central European panties.

>run west
You can't go that way.

The pusher eyes your pair of Central European panties.

>run southeast
Copenhagen Metro Station
This is the main metro station in Copenhagen. Its creator won the Best Dane of the Year Award.

Stairs lead southward and upward to the IIT Campus exit. Christiana is northwest of here: this much you know.

The Danes are very efficient: you can also take a direct route west from here to the Aarenhus Cemetery.

A small door stands in the southeast corner of the station near a fake tree.

You can see the fake tree (closed) here.

>go west
Aarenhus Cemetery
Dark paths run here and there among the marble tombs. Some trees provide relaxing shade, and white flowers bloom here and there.

You can see several flowers here.

>eat flower
That's definitely not edible.

>put tomb in backpack
You can't see any such thing.

>put tombs in backpack
(first taking the marble tombs)
They're hardly portable.

>put shade in backpack
You can't see any such thing.

>pick flowers
I didn't understand that sentence.

>take flowers
flower: You pluck a flower from where it grows.
flower: You pluck a flower from where it grows.
flower: You pluck a flower from where it grows.
flower: You pluck a flower from where it grows.
flower: You pluck a flower from where it grows.
flower: You pluck a flower from where it grows.
flower: You pluck a flower from where it grows.
flower: You pluck a flower from where it grows.
flower: You pluck a flower from where it grows.
flower: You pluck a flower from where it grows.

>eat flower
That's definitely not edible.

>take trees
They're hardly portable.

>ex flower
That's not a verb I recognize.

>examine flowers
You can't use multiple objects with that verb.

>x flower
Slender and delicate.

>go north
You can't go that way.

>go west
You can't go that way.

>go east
Copenhagen Metro Station
This is the main metro station in Copenhagen. Its creator won the Best Dane of the Year Award.

Stairs lead southward and upward to the IIT Campus exit. Christiana is northwest of here: this much you know.

The Danes are very efficient: you can also take a direct route west from here to the Aarenhus Cemetery.

A small door stands in the southeast corner of the station near a fake tree.

You can see a C-Train (empty) and the fake tree (closed) here.

>go southeast
(first opening the small door)

The Path
This odd little path runs out of the metro station and toward an isolated hill overlooking the bay. The ground is grassy, but the only larger vegetation is a gnarled bush.

>take bush
That's hardly portable.

>i
You are carrying:
  ten flowers
  a backpack (open)
    bedsheets
    a steak
    a piece of cheese
    a wallet
      6 kroner
      1 Uncle Sam
    a dwarf banana tree
    a loaf of bread
  a pair of Central European panties

>take train
You can't see any such thing.

>so northwest
That's not a verb I recognize.

>go northwest
Copenhagen Metro Station
This is the main metro station in Copenhagen. Its creator won the Best Dane of the Year Award.

Stairs lead southward and upward to the IIT Campus exit. Christiana is northwest of here: this much you know.

The Danes are very efficient: you can also take a direct route west from here to the Aarenhus Cemetery.

A small door stands in the southeast corner of the station near a fake tree.

You can see the fake tree (closed) here.

>go south
IIT Campus
The campus is pretty sleepy in the summer. A construction crew works below the bell tower, but the only student you see is Ana.

You can see Ana and a stone bench here.

>smell ana
You smell nothing unexpected.

>touch ana's face
You can't see any such thing.

>blow on ana
That's not a verb I recognize.

>sex minigame
That's not a verb I recognize.

>scream loudly
That's not a verb I recognize.

>slap ana
That's not a verb I recognize.

>give ana flowers
You can't use multiple objects with that verb.

>give ana flower
Ana sighs and kisses your cheek. She strolls over to the bench, and sits down to gaze at the flower.

[Your score has just gone up by one point.]

>speak ana
(to Ana)
There is no reply.

>take ana
Sadly, that will have to wait for later.

>take ana as your own
I only understood you as far as wanting to take Ana.

>are you alive?
That's not a verb I recognize.

>give flower ana
You can only do that to something animate.

>give flower to ana
Ana giggles.

>giggle
That's not a verb I recognize.

>give flower to ana
Ana grins.

>give flower to ana
Ana blushes.

>go south
You can't go that way.

>speak construction crew
(to Ana)
There is no reply.

>look
IIT Campus
The campus is pretty sleepy in the summer. A construction crew works below the bell tower, but no students are to be seen.

You can see a stone bench (on which is Ana) here.

>go to bell tower
You can't see any such thing.

>speak construction crew
(to Ana)
There is no reply.

>go south
You can't go that way.

>go north
Copenhagen Metro Station
This is the main metro station in Copenhagen. Its creator won the Best Dane of the Year Award.

Stairs lead southward and upward to the IIT Campus exit. Christiana is northwest of here: this much you know.

The Danes are very efficient: you can also take a direct route west from here to the Aarenhus Cemetery.

A small door stands in the southeast corner of the station near a fake tree.

You can see a C-Train (empty) and the fake tree (closed) here.

>go west
Aarenhus Cemetery
Dark paths run here and there among the marble tombs. Some trees provide relaxing shade, and white flowers bloom here and there.

>take flowers
What do you want to take those things from?

>take flower
You've already picked all the good ones.

>relax
That's not a verb I recognize.

>sit under shade
I didn't understand that sentence.

>sit tree
I didn't understand that sentence.

>go to tree
You can't see any such thing.

>go east
Copenhagen Metro Station
This is the main metro station in Copenhagen. Its creator won the Best Dane of the Year Award.

Stairs lead southward and upward to the IIT Campus exit. Christiana is northwest of here: this much you know.

The Danes are very efficient: you can also take a direct route west from here to the Aarenhus Cemetery.

A small door stands in the southeast corner of the station near a fake tree.

You can see a C-Train (empty) and the fake tree (closed) here.

The C-Train departs without you.

>wait
Time passes.

>wai
That's not a verb I recognize.

>wait
Time passes.

* * *

>r
Time passes.

The C-Train arrives.

>r
Time passes.

>go to C-Train
You can't see any such thing.

>enter C-Train
You get into the C-Train.

>r
Time passes.

* * *

I beg your pardon?

>r
Time passes.

The C-Train departs, taking you into a tunnel.

* * *

>r
Time passes.

>r
Time passes.

You arrive in Hellerup.

>r
Time passes.

>r
Time passes.

You arrive in Copenhagen.

>r
Time passes.

>exit
You can't get out while the train is moving.

>r
Time passes.

* * *

>r
Time passes.

You arrive in Hellerup.

>exit
Train Platform
The open-air train platform has a line that runs to Copenhagen every 10 minutes. There are no tickets: just line up and wait for the next train to come.

You can see a C-Train (empty) here.

>take C-Train
(putting the pair of Central European panties into the backpack to make room)
You're carrying too many things already.

>put C-Train in backpack
(first taking the C-Train)
(putting the flower into the backpack to make room)
You're carrying too many things already.

>go north
You can't go that way.

>go east
Hellerup Strandvejen
The main street of Hellerup is bordered on its north side by brightly-painted row houses, such as the one containing your apartment. At the east end is a dock, and if you go west you can catch a train.

You can see an apartment door, a street vendor and a wheelbarrow (in which are a pile of herring and a mound of herring) here.

The vendor calls out, "Today I have a pile of herring and a mound of herring! Fresh!"

>go east
Dock
This is a shabby little dock used for the fishing trade. At the end of the dock, a little rowboat, moored with a rope, bobs up and down. In the rowboat is a large crate, atop which sits a bird.

>enter rowboat
It's much too slippery for a landlubber like you to get in.

>untie rowboat
That's not a verb I recognize.

>take crate
That's fixed in place.

>open crate
It isn't something you can open.

>take bird
You can't take a living thing!

>eat bird
That's definitely not edible.

>kill bird
Violence isn't the answer to this one.

>x bird
The species is impossible to identify, but its plumage is wilted, its beak is crooked, and its eyes are dull.

>fish
That's not a verb I recognize.

>x boat
This rowboat is sad but serviceable.

In the rowboat is the herring crate.

>take herring crate
That's fixed in place.

>take herring
That's fixed in place.

>east
You can't go that way.

>go west
Hellerup Strandvejen
The main street of Hellerup is bordered on its north side by brightly-painted row houses, such as the one containing your apartment. At the east end is a dock, and if you go west you can catch a train.

You can see an apartment door, a street vendor and a wheelbarrow (in which are a pile of herring and a mound of herring) here.

>steal fish
That's not a verb I recognize.

>take herring
Which do you mean, the fistful of herring, the pile of herring or the mound of herring?

>pile
That costs money.

The vendor calls out, "Today I have a pile of herring and a mound of herring! Fresh!"

>take anyways
You can't see any such thing.

>steal pile
That's not a verb I recognize.

>kill vendor
Violence isn't the answer to this one.

>sell flowers
That's not a verb I recognize.

>sell flower
That's not a verb I recognize.

>eat steak
(first taking the steak)
(putting the flower into the backpack to make room)
You're carrying too many things already.

The vendor calls out, "Today I have a pile of herring and a mound of herring! Fresh!"

>hold steak
(putting the flower into the backpack to make room)
You're carrying too many things already.

>hold C-Train
You can't see any such thing.

>i
You are carrying:
  three flowers
  a backpack (open)
    three flowers
    a pair of Central European panties
    bedsheets
    a steak
    a piece of cheese
    a wallet
      6 kroner
      1 Uncle Sam
    a dwarf banana tree
    a loaf of bread

>eat bread
(first taking the loaf of bread)
(putting the flower into the backpack to make room)
You're carrying too many things already.

The vendor calls out, "Today I have a pile of herring and a mound of herring! Fresh!"

>i
You are carrying:
  two flowers
  a backpack (open)
    four flowers
    a pair of Central European panties
    bedsheets
    a steak
    a piece of cheese
    a wallet
      6 kroner
      1 Uncle Sam
    a dwarf banana tree
    a loaf of bread

The vendor calls out, "Today I have a pile of herring and a mound of herring! Fresh!"

>drop bedsheets
You haven't got that.

>exit bedsheets
I only understood you as far as wanting to exit.

>make the bedsheets go away
That's not a verb I recognize.

>i
You are carrying:
  two flowers
  a backpack (open)
    four flowers
    a pair of Central European panties
    bedsheets
    a steak
    a piece of cheese
    a wallet
      6 kroner
      1 Uncle Sam
    a dwarf banana tree
    a loaf of bread

I beg your pardon?

>drop sheets
You haven't got that.

I beg your pardon?

>drop flower. drop flower
Dropped.

Dropped.

The vendor calls out, "Today I have a pile of herring and a mound of herring! Fresh!"

>i
You are carrying:
  a backpack (open)
    four flowers
    a pair of Central European panties
    bedsheets
    a steak
    a piece of cheese
    a wallet
      6 kroner
      1 Uncle Sam
    a dwarf banana tree
    a loaf of bread

>eat bread
(first taking the loaf of bread)
You eat the loaf of bread. Not bad.

>eat cheese
(first taking the piece of cheese)
You eat the piece of cheese. Not bad.

The vendor calls out, "Today I have a pile of herring and a mound of herring! Fresh!"

>eat four flowers
You can't use multiple objects with that verb.

>eat bedsheets
That's definitely not edible.

The vendor calls out, "Today I have a pile of herring and a mound of herring! Fresh!"

>eat steak
(first taking the steak)
You eat the steak. Not bad.

The vendor calls out, "Today I have a pile of herring and a mound of herring! Fresh!"

>x herring
Which do you mean, the fistful of herring, the pile of herring or the mound of herring?

>moun
You can't see any such thing.

>mound
That's not a verb I recognize.

>x mound
Moist and fresh.

It costs 2 kroner.

The vendor calls out, "Today I have a pile of herring and a mound of herring! Fresh!"

>uy
That's not a verb I recognize.

>buy mound
You pay 2 kroner for the mound of herring, leaving yourself with 4 kroner.

The vendor calls out, "Today I have a pile of herring! Fresh!"

>eat mound
You eat the mound of herring. Not bad.

>north
Apartment
Your apartment is a cheery little box. On the east wall is a round window. A woven rug adorns the floor in the middle of the room. Along the west wall are a fridge and some shelves. A bed lies in the northwest corner, and a stove lies in the northeast.

On the stove is a frying pan.

You can also see an apartment door, a fridge (in which is a glass bottle (closed) (in which is some Dankdrinke)) and the bed here.

>open glass botle
I only understood you as far as wanting to open the glass bottle.

>drink dankdrinke
You open the glass bottle.

(first taking the Dankdrinke)
Your throat is filled with ergonomitivity.

[Your score has just gone up by one point.]

>break bottle
Violence isn't the answer to this one.

>go to sleep
You can't see any such thing.

>go to bed
You can't see any such thing.

>sleep
You aren't feeling especially drowsy.

>stop breathing
That's not a verb I recognize.

>kill self
Violence isn't the answer to this one.

>open window
It isn't something you can open.

* * *

>break window
Violence isn't the answer to this one.

>put rug in backpack
(first taking the rug)
You couldn't possibly take that! It belongs to your landlady.

>exit
But you aren't in anything at the moment.

>go through door
Hellerup Strandvejen
The main street of Hellerup is bordered on its north side by brightly-painted row houses, such as the one containing your apartment. At the east end is a dock, and if you go west you can catch a train.

You can see an apartment door, a couple of flowers, a street vendor and a wheelbarrow (in which is a pile of herring) here.

>take wheelbarrow
Taken.

>take flowers
flower: Taken.
flower: (putting the wheelbarrow into the backpack to make room)
Taken.

The vendor calls out, "Today I have a pile of herring! Fresh!"

>take pile
That costs money.

>i
You are carrying:
  two flowers
  a backpack (open)
    a wheelbarrow
      a pile of herring
    four flowers
    a pair of Central European panties
    bedsheets
    a wallet
      4 kroner
      1 Uncle Sam
    a dwarf banana tree

>go north
Apartment
Your apartment is a cheery little box. On the east wall is a round window. A woven rug adorns the floor in the middle of the room. Along the west wall are a fridge and some shelves. A bed lies in the northwest corner, and a stove lies in the northeast.

On the stove is a frying pan.

You can also see an apartment door, a fridge (in which is a glass bottle (empty)) and the bed here.

>fry pile
That's not a verb I recognize.

>cook pile
That's not a verb I recognize.

>eat pile
(first taking the pile of herring)
That costs money.

>buy pile
You pay 1 kroner for the pile of herring, leaving yourself with 3 kroner.

>eat pile
You eat the pile of herring. Not bad.

>drop wheelbarrow
You haven't got that.

>i
You are carrying:
  two flowers
  a backpack (open)
    a wheelbarrow
    four flowers
    a pair of Central European panties
    bedsheets
    a wallet
      3 kroner
      1 Uncle Sam
    a dwarf banana tree

>x flowers
You can't use multiple objects with that verb.

>x flower
Somewhat wilted.

>drop flower
Dropped.

>ddrop flower
That's not a verb I recognize.

>drop flower
Dropped.

>i
You are carrying:
  a backpack (open)
    a wheelbarrow
    four flowers
    a pair of Central European panties
    bedsheets
    a wallet
      3 kroner
      1 Uncle Sam
    a dwarf banana tree

>drop barrow
You can't see any such thing.

>drop wheelbarrow
You haven't got that.

>i
You are carrying:
  a backpack (open)
    a wheelbarrow
    four flowers
    a pair of Central European panties
    bedsheets
    a wallet
      3 kroner
      1 Uncle Sam
    a dwarf banana tree

>take wheelbarrow
Taken.

>drop wheelbarrow
Dropped.

>go through door
Hellerup Strandvejen
The main street of Hellerup is bordered on its north side by brightly-painted row houses, such as the one containing your apartment. At the east end is a dock, and if you go west you can catch a train.

You can see an apartment door and a street vendor here.

>drop wallet
You haven't got that.

>x wallet
In the wallet are 3 kroner and 1 Uncle Sam.

>eat kroner
You can't see any such thing.

>drop kroner
You can't see any such thing.

>drop money
You haven't got that.

>take money
No need to do anything with that until you want to buy something.

>smell money
You smell nothing unexpected.

I beg your pardon?

>west
Train Platform
The open-air train platform has a line that runs to Copenhagen every 10 minutes. There are no tickets: just line up and wait for the next train to come.

>r
Time passes.

* * *

>r
Time passes.

The C-Train arrives.

>take C-train
Taken.

>enter C-Train
You can only get into something free-standing.

>drop c-train
Dropped.

>enter c-train
You get into the C-Train.

I beg your pardon?

* * *

>r
Time passes.

You arrive in Copenhagen.

>take c-train
You would have to get out of the C-Train first.

>exit
Copenhagen Metro Station
This is the main metro station in Copenhagen. Its creator won the Best Dane of the Year Award.

Stairs lead southward and upward to the IIT Campus exit. Christiana is northwest of here: this much you know.

The Danes are very efficient: you can also take a direct route west from here to the Aarenhus Cemetery.

A small door stands in the southeast corner of the station near a fake tree.

You can see a C-Train (empty) and the fake tree (closed) here.

>take C-train
Taken.

>take fake tree
Taken.

>southeast
The Path
This odd little path runs out of the metro station and toward an isolated hill overlooking the bay. The ground is grassy, but the only larger vegetation is a gnarled bush.

>i
You are carrying:
  the fake tree (closed and locked)
  a backpack (open)
    four flowers
    a pair of Central European panties
    bedsheets
    a wallet
      3 kroner
      1 Uncle Sam
    a dwarf banana tree

>unlock fake tree
What do you want to unlock the fake tree with?

>flower
(first taking the flower)
That doesn't seem to fit the lock.

>unlock fake tree
What do you want to unlock the fake tree with?

>finger
You can't see any such thing.

>C-train
That's not a verb I recognize.

>unlock fake tree
What do you want to unlock the fake tree with?

>money
(first taking 3 kroner)
No need to do anything with that until you want to buy something.

>southeas
That's not a verb I recognize.

>southeast
You can't go that way.

>east
You can't go that way.

>south
You can't go that way.

>burn grass
You can't see any such thing.

>grass
That's not a verb I recognize.

>x grass
You can't see any such thing.

>x green grass
You can't see any such thing.

>look
The Path
This odd little path runs out of the metro station and toward an isolated hill overlooking the bay. The ground is grassy, but the only larger vegetation is a gnarled bush.

>x ground
You can't see any such thing.

>x bush
You see nothing special about the gnarled bush.

>burn bush
This dangerous act would achieve little.

>i dont care
I only understood you as far as wanting to take inventory.

>take bush
That's hardly portable.

>sit on bush
That's not something you can sit down on.

>eat bush
That's definitely not edible.

>punch bush
Violence isn't the answer to this one.

>enter bush
That's not something you can enter.

>get on bush
That's not something you can enter.

>erase bush
That's not a verb I recognize.

>kill bush
Violence isn't the answer to this one.

>make bush suffer horribly
That's not a verb I recognize.

>purloin c-train
[Purloined.]

>i
You are carrying:
  a C-Train
  a flower
  the fake tree (closed and locked)
  a backpack (open)
    three flowers
    a pair of Central European panties
    bedsheets
    a wallet
      3 kroner
      1 Uncle Sam
    a dwarf banana tree

>x train
This train is made of 7 round glass pods. Each pod contains a sofa.

>i
You are carrying:
  a C-Train
  a flower
  the fake tree (closed and locked)
  a backpack (open)
    three flowers
    a pair of Central European panties
    bedsheets
    a wallet
      3 kroner
      1 Uncle Sam
    a dwarf banana tree

>i
You are carrying:
  a C-Train
  a flower
  the fake tree (closed and locked)
  a backpack (open)
    three flowers
    a pair of Central European panties
    bedsheets
    a wallet
      3 kroner
      1 Uncle Sam
    a dwarf banana tree

>i
You are carrying:
  a flower
  the fake tree (closed and locked)
  a backpack (open)
    three flowers
    a pair of Central European panties
    bedsheets
    a wallet
      3 kroner
      1 Uncle Sam
    a dwarf banana tree

* * *

>get pack
Taken.

>go south
(first opening the apartment door)

Hellerup Strandvejen
The main street of Hellerup is bordered on its north side by brightly-painted row houses, such as the one containing your apartment. At the east end is a dock, and if you go south you can catch a train.

You can see a street vendor and a wheelbarrow (in which is three piles of herring) here.

>put pack in wheelbarrow
You put the backpack into the wheelbarrow.

* * *

>get panties
Nice.

[Your score has just gone up by one point.]

>drop panties
Dropped.

>take panties
Taken.

>take panties
You already have that.

* * *

>drop panties
Dropped.

>get panties
Taken.

>x panties
Pink and frilly. You should probably return those.

>put away panties
You can't see any such thing.

>put panties in backpack
You put the pair of Central European panties into the backpack.

>x backpack
Adorned with the seal of Reed College, your undergraduate alma mater.

In the backpack is a pair of Central European panties.

>drop backpack
Dropped.

>go south
(first opening the apartment door)
You can't go to school without your backpack.

* * *

>go south
(first opening the apartment door)
You can't go to school without your backpack.

>get pack
Taken.

>go south
(first opening the apartment door)

Hellerup Strandvejen
The main street of Hellerup is bordered on its north side by brightly-painted row houses, such as the one containing your apartment. At the east end is a dock, and if you go south you can catch a train.

You can see a street vendor and a wheelbarrow (in which are a pile of herring and a mound of herring) here.

>go dock
You can't see any such thing.

* * *

>go south
(first opening the apartment door)
You can't go to school without your backpack.

>x vendor
A friendly purveyor of herring, and perhaps more. He wears a long coat, one fingerless glove, a pair of trousers and a pair of sneakers.

>x coat
The vendor's coat has clearly seen better days. From the sole remaining pocket protrudes a fistful of herring.

>take herring
Which do you mean, the fistful of herring or the pile of herring?

>take fistful of herring
That seems to belong to the street vendor.

>take coat
That seems to belong to the street vendor.

>talk vendor
That's not a verb I recognize.

>speak vendor
(to the street vendor)
There is no reply.

>push
(the backpack)
Nothing obvious happens.

>push backpack
Nothing obvious happens.

>push wheelbarrow
Nothing obvious happens.

>shove wheelbarrow
That's not a verb I recognize.

>pull wheelbarrow
Nothing obvious happens.

>x wheelbarrow
In the wheelbarrow is a pile of herring.

>x herring
Which do you mean, the fistful of herring or the pile of herring?

>x coat
You see nothing special about the long coat.

>x pockert
You can't see any such thing.

>x pocket
In the pocket is a fistful of herring.

* * *

>x coat
The vendor's coat has clearly seen better days. From the sole remaining pocket protrudes a fistful of herring.

>x glove
You see nothing special about one fingerless glove.

>x trousers
You see nothing special about the pair of trousers.

>x sneakers
You see nothing special about the pair of sneakers.

* * *

>x vendor
A friendly purveyor of herring, and perhaps more. He wears a long coat, one fingerless glove, a pair of trousers and a pair of sneakers.

>x vendor
A friendly purveyor of fish and other goods.

>take coat
That seems to belong to the street vendor.

>take herring
That seems to belong to the street vendor.

* * *

>gonear ana
IIT Campus
The campus is pretty sleepy in the summer. A construction crew works below the bell tower, but the only student you see is Ana.

You can see Ana and a stone bench here.

>kiss ana
Ana slaps the kiss right off your lips.

>purloin steak
[Purloined.]

>give ana steak
She slaps the steak out of your hand.

>sit bench
I didn't understand that sentence.

>sit on bench
That's not something you can sit down on.

>purloin flower
[Purloined.]

>give ana flower
Ana sighs and kisses your cheek. She strolls over to the bench, and sits down to gaze at the flower.

[Your score has just gone up by one point.]

>kiss ana
Ana might not like that.

>touch ana
Ana might not like that.

>rules
Rules tracing now switched on. Type "rules off" to switch it off again, or "rules all" to include even rules which do not apply.

>touch ana
[Rule "declare everything initially unmentioned rule" applies.]
[Rule "announce items from multiple object lists rule" applies.]
[Rule "set pronouns from items from multiple object lists rule" applies.]
[Rule "before stage rule" applies.]
[Rule "sanity-check stage rule" applies.]
[Rule "instead stage rule" applies.]
[Rule "investigate player's awareness before action rule" applies.]
[Rule "player aware of his own actions rule" applies.]
[Rule "check stage rule" applies.]
[Rule "carry out stage rule" applies.]
[Rule "after stage rule" applies.]
[Rule "investigate player's awareness after action rule" applies.]
[Rule "report stage rule" applies.]
[Rule "report touching yourself rule" applies.]
[Rule "report touching other people rule" applies.]
Ana might not like that.
[Rule "last specific action-processing rule" applies.]

[Rule "A first turn sequence rule" applies.]
[Rule "every turn stage rule" applies.]
[Rule "A last turn sequence rule" applies.]
[Rule "notify score changes rule" applies.]

* * *

>gonear ana
IIT Campus
The campus is pretty sleepy in the summer. A construction crew works below the bell tower, but the only student you see is Ana.

You can see Ana and a stone bench here.

>press ana
She slaps your hand away.

>push ana
She slaps your hand away.

>purloin flower
Which do you mean, the red flower, the white flower, the blue flower or the yellow flower?

>gred
There seems to be no such object anywhere in the model world.

>purloin red
[Purloined.]

>l
IIT Campus
The campus is pretty sleepy in the summer. A construction crew works below the bell tower, but the only student you see is Ana.

You can see Ana and a stone bench here.

>i
You are carrying:
  a red flower
  a wallet
    5 kroner
    1 Uncle Sam

>give red to ana
Ana sighs and kisses your cheek. She strolls over to the bench, and sits down to gaze at the flower.

[Your score has just gone up by one point.]

>take ana
Sadly, Ana isn't here.

>l ana
A Czech girl. Starting next week, she's your TA for Introductory Programming. Starting last night, she's your lover.

>l
IIT Campus
The campus is pretty sleepy in the summer. A construction crew works below the bell tower, but no students are to be seen.

You can see a stone bench (on which is Ana) here.

* * *

>gonear ana
IIT Campus
The campus is pretty sleepy in the summer. A construction crew works below the bell tower, but the only student you see is Ana.

You can see Ana and a stone bench here.

>try pushing ana
That's not a verb I recognize.

>push ana
She slaps your hand away.

>purloin red. give red. touch ana
[Purloined.]

You can only do that to something animate.

>push ana
She slaps your hand away.

>give red
(to Ana)
Ana sighs and kisses your cheek. She strolls over to the bench, and sits down to gaze at the flower.

[Your score has just gone up by one point.]

>push ana
You caress her, and she rubs her head against your hand.

>touch ana
You caress her, and she rubs her head against your hand.

>press ana
You caress her, and she rubs her head against your hand.

>x
(the wallet)
You picked this bad boy up in Italy. It's a genuine Silvatorio Mossaganezza.

In the wallet are 5 kroner and 1 Uncle Sam.

>i
You are carrying:
  a wallet
    5 kroner
    1 Uncle Sam

>x sam
The hardest currency on Earth.

A single tear leaks out as you contemplate the majesty of the USD.

>x sam
The hardest currency on Earth.

>l
IIT Campus
The campus is pretty sleepy in the summer. A construction crew works below the bell tower, but no students are to be seen.

You can see a stone bench (on which is Ana) here.

>eat ana
Foolish American, have you truly mistaken Ana for food?

>x crew
You can't see any such thing.

>piss
That's not a verb I recognize.

>go metro
You can't see any such thing.

>n
Copenhagen Metro Station
This is the main metro station in Copenhagen. Its creator won the Best Dane of the Year Award.

Stairs lead southward and upward to the IIT Campus exit. Christiana is northwest of here: this much you know.

The Danes are very efficient: you can also take a direct route west from here to the Aarenhus Cemetery.

A small door stands in the southeast corner of the station near a fake tree.

You can see the fake tree here.

>w
Aarenhus Cemetery
Dark paths run here and there among the marble tombs. Some trees provide relaxing shade, and flowers bloom here and there.

You can see a white flower, a blue flower and a yellow flower here.

>n
You can't go that way.

>e
Copenhagen Metro Station
This is the main metro station in Copenhagen. Its creator won the Best Dane of the Year Award.

Stairs lead southward and upward to the IIT Campus exit. Christiana is northwest of here: this much you know.

The Danes are very efficient: you can also take a direct route west from here to the Aarenhus Cemetery.

A small door stands in the southeast corner of the station near a fake tree.

You can see the fake tree here.

>ls
That's not a verb I recognize.

>l
Copenhagen Metro Station
This is the main metro station in Copenhagen. Its creator won the Best Dane of the Year Award.

Stairs lead southward and upward to the IIT Campus exit. Christiana is northwest of here: this much you know.

The Danes are very efficient: you can also take a direct route west from here to the Aarenhus Cemetery.

A small door stands in the southeast corner of the station near a fake tree.

You can see the fake tree here.

>x door
It's not even a finished door - just a plank of wood on hinges. A sign hangs from a nail in the middle.

The C-Train arrives.

>x sign
The hand-lettered sign reads, "My friend, you've gotten 1 points so far."

>x tree
A huge plastic palm tree, fifteen feet tall and twenty feet around. It 'grows' from an inch-thick disc of marble which is set into the floor of the station, disrupting the pattern of tiles around it.

* * *

>gonear bird
Who do you mean, the friendly bird or the wretched bird?

>friendly bird
*** Run-time problem P61: Attempt to move the player off-stage.

>restart
Are you sure you want to restart?

>y
Limbo has no description.
wallet has no description.
row houses has no description.
herring crate has no description.
paper kroner has no description.
fake tree has no description.

It is the Year of Our Lord MMXVIII. You have arrived in the Danish city of Copenhagen to pursue a master's degree. You found an apartment for let in the suburb of Hellerup, and promptly moved in. The place isn't much, but for the next two years it's home. 

PREPARE YOUR SPIRIT FOR . . .

RYAN QUEST 2
An Interactive Fiction by Maxwell Joslyn
Release 1 / Serial number 181128 / Inform 7 build 6M62 (I6/v6.33 lib 6/12N) SD

Apartment
Your apartment is a cheery little box. On the east wall is a round window. A woven rug adorns the floor in the middle of the room. Along the west wall are a fridge and some shelves. A bed lies in the northwest corner, and a stove lies in the northeast.

On the stove is a frying pan.

On the shelves is a loaf of bread.

You can also see an apartment door, a backpack (empty), a dwarf banana tree, a fridge (closed) and the bed (on which are bedsheets and a pair of Central European panties) here.

>gonear wretched bird
Dock
This is a shabby little dock used for the fishing trade. At the end of the dock, a little rowboat, moored with a rope, bobs up and down. In the rowboat is a large crate, atop which sits a bird.

>kiss bird
The wretched bird shies away from your searching lips.

>kiss bird
The wretched bird shies away from your soft lips.

>gonear rug
Apartment
Your apartment is a cheery little box. On the east wall is a round window. A woven rug adorns the floor in the middle of the room. Along the west wall are a fridge and some shelves. A bed lies in the northwest corner, and a stove lies in the northeast.

On the stove is a frying pan.

On the shelves is a loaf of bread.

You can also see an apartment door, a backpack (empty), a dwarf banana tree, a fridge (closed) and the bed (on which are bedsheets and a pair of Central European panties) here.

>take bread. open fridge. take cheese. take steak.
Taken.

You open the fridge, revealing a piece of cheese, a steak and a glass bottle.

Taken.

You're carrying too many things already.

>drop all
piece of cheese: Dropped.
loaf of bread: Dropped.
wallet: Dropped.

>take pack
Taken.

>take wallet, cheese, and bread.
You can't see any such thing.

>take wallet. take cheese. take bread
Taken.

Taken.

(putting the wallet into the backpack to make room)
Taken.

>i
You are carrying:
  a loaf of bread
  a piece of cheese
  a backpack (open)
    a wallet
      5 kroner
      1 Uncle Sam

>take steak
(putting the piece of cheese into the backpack to make room)
Taken.

>drink dankdrinke
You open the glass bottle.

(first taking the Dankdrinke)
(putting the loaf of bread into the backpack to make room)
Your throat is filled with ergonomitivity.

[Your score has just gone up by one point.]

>s
(first opening the apartment door)

Hellerup Strandvejen
The main street of Hellerup is bordered on its north side by brightly-painted row houses, such as the one containing your apartment. At the east end is a dock, and if you go west you can catch a train.

You can see an apartment door, a street vendor and a wheelbarrow (in which are a pile of herring and a mound of herring) here.

>give fridge to vendor
You can't see any such thing.

>give steak to vendor
The street vendor does not desire a steak.

>drop staek
You can't see any such thing.

>drop steak
Dropped.

>give steak to vendor
The street vendor does not desire a steak.

>actions
Actions listing on.

>activites
That's not a verb I recognize.

>activities
That's not a verb I recognize.

>log
That's not a verb I recognize.

>logging
That's not a verb I recognize.

>give steak to vendor
[giving the steak to the street vendor]
The street vendor does not desire a steak.
[giving the steak to the street vendor - ended without result]

The vendor calls out, "Today I have a pile of herring and a mound of herring! Fresh!"

>i
[taking inventory]
You are carrying:
  a backpack (open)
    a loaf of bread
    a piece of cheese
    a wallet
      5 kroner
      1 Uncle Sam

[taking inventory - succeeded]

The vendor calls out, "Today I have a pile of herring and a mound of herring! Fresh!"

>i
[taking inventory]
You are carrying:
  a backpack (open)
    a loaf of bread
    a piece of cheese
    a wallet
      5 kroner
      1 Uncle Sam

[taking inventory - succeeded]

>l
[looking]
Hellerup Strandvejen
The main street of Hellerup is bordered on its north side by brightly-painted row houses, such as the one containing your apartment. At the east end is a dock, and if you go west you can catch a train.

You can see a steak, an apartment door, a street vendor and a wheelbarrow (in which are a pile of herring and a mound of herring) here.

[looking - succeeded]

>take steak
[taking the steak]
Taken.
[taking the steak - succeeded]

>w
[going west]

Train Platform
The open-air train platform has a line that runs to Copenhagen every 10 minutes. There are no tickets: it is free to ride.

You can see a C-Train (in which is a wrap-around sofa) and a paper kroner here.

[going west - succeeded]

>drop steak
[dropping the steak]
Dropped.
[dropping the steak - succeeded]

>e
[going east]

Hellerup Strandvejen
The main street of Hellerup is bordered on its north side by brightly-painted row houses, such as the one containing your apartment. At the east end is a dock, and if you go west you can catch a train.

You can see an apartment door, a street vendor and a wheelbarrow (in which are a pile of herring and a mound of herring) here.

[going east - succeeded]

The vendor calls out, "Today I have a pile of herring and a mound of herring! Fresh!"

>give steak to vendor
You can't see any such thing.

* * *

>gonear bird
Who do you mean, the friendly bird or the wretched bird?

>wretched
Dock
This is a shabby little dock used for the fishing trade. At the end of the dock, a little rowboat, moored with a rope, bobs up and down. In the rowboat is a large crate, atop which sits a bird.

>purloin pile. feed pile to bird.
[Purloined.]

The wretched bird regards you warily, then opens its beak and snaps up the pile of herring. It swallows in one gulp.

You see a flash of brilliance in its black, beady eyes. Then it caws, and flies off in the direction of Copenhagen.

You feel strangely proud.

[Your score has just gone up by one point.]

>i
You are carrying:
  a wallet
    5 kroner
    1 Uncle Sam

>enter crate
(getting into the rowboat)
The rowboat is much too slippery for a landlubber like you to get in.

* * *

>gonear button
IIT Campus
The campus is pretty sleepy in the summer. A construction crew works below the bell tower, but the only student you see is Ana.

You can see Ana and a stone bench here.

>l
IIT Campus
The campus is pretty sleepy in the summer. A construction crew works below the bell tower, but the only student you see is Ana.

You can see Ana and a stone bench here.

>l button
The button is currently switched off.

>x bench
Effortlessly square.

On the base, nearly invisible, is a beige button.

>l bench
Effortlessly square.

On the base, nearly invisible, is a beige button.

>x button
The button is currently switched off.

* * *

>gonear button
IIT Campus
The campus is pretty sleepy in the summer. A construction crew works below the bell tower, but the only student you see is Ana.

You can see Ana and a stone bench here.

>press button
Somewhere nearby, a voice yells, 'G!'.

* * *

>gonear button
IIT Campus
The campus is pretty sleepy in the summer. A construction crew works below the bell tower, but the only student you see is Ana.

You can see Ana and a stone bench here.

>press button. press button. press button. press button.
A voice yells, '1!'
You switch the button off.

A voice yells, '2!'
You switch the button off.

* * *

>gonear button
IIT Campus
The campus is pretty sleepy in the summer. A construction crew works below the bell tower, but the only student you see is Ana.

You can see Ana and a stone bench here.

>test butt
(Testing.)

>[1] gonear button
IIT Campus
The campus is pretty sleepy in the summer. A construction crew works below the bell tower, but the only student you see is Ana.

You can see Ana and a stone bench here.

>[2] press button
A voice yells, 'F!'
>[3] g
A voice yells, 'E!'
>[4] g
A voice yells, 'E!'
>[5] g
A voice yells, 'D!'
>[6] g
A voice yells, 'B!'
>[7] g
A voice yells, 'I!'
>[8] g
A voice yells, 'R!'
>[9] g
A voice yells, 'D!'

>x bench
Effortlessly square.

On the base, nearly invisible, is an unlabelled beige button.

* * *

>gonear button
IIT Campus
The campus is pretty sleepy in the summer. A construction crew works below the bell tower, but the only student you see is Ana.

You can see Ana and a stone bench here.

>x benc
You can't see any such thing.

>x bench
Effortlessly square.

On the base, nearly invisible, is an unlabelled beige button.

>x button
The button is currently switched off.

>press button
PENIS

>gonear panties
Apartment
Your apartment is a cheery little cube. On the east wall is a round window. A woven rug adorns the floor in the middle of the room. Along the west wall are a fridge and some shelves. A bed lies in the northwest corner, and a stove lies in the northeast.

On the stove is a frying pan.

On the shelves is a loaf of bread.

You can also see an apartment door, a backpack (empty), a dwarf banana tree, a fridge (closed) and the bed (on which are bedsheets and a pair of Central European panties) here.

>gonear underwear
Apartment
Your apartment is a cheery little cube. On the east wall is a round window. A woven rug adorns the floor in the middle of the room. Along the west wall are a fridge and some shelves. A bed lies in the northwest corner, and a stove lies in the northeast.

On the stove is a frying pan.

On the shelves is a loaf of bread.

You can also see an apartment door, a backpack (empty), a dwarf banana tree, a fridge (closed) and the bed (on which are bedsheets and a pair of Central European panties) here.

>gonear central
Apartment
Your apartment is a cheery little cube. On the east wall is a round window. A woven rug adorns the floor in the middle of the room. Along the west wall are a fridge and some shelves. A bed lies in the northwest corner, and a stove lies in the northeast.

On the stove is a frying pan.

On the shelves is a loaf of bread.

You can also see an apartment door, a backpack (empty), a dwarf banana tree, a fridge (closed) and the bed (on which are bedsheets and a pair of Central European panties) here.

>gonear european
Apartment
Your apartment is a cheery little cube. On the east wall is a round window. A woven rug adorns the floor in the middle of the room. Along the west wall are a fridge and some shelves. A bed lies in the northwest corner, and a stove lies in the northeast.

On the stove is a frying pan.

On the shelves is a loaf of bread.

You can also see an apartment door, a backpack (empty), a dwarf banana tree, a fridge (closed) and the bed (on which are bedsheets and a pair of Central European panties) here.

>gonear underwear
Apartment
Your apartment is a cheery little cube. On the east wall is a round window. A woven rug adorns the floor in the middle of the room. Along the west wall are a fridge and some shelves. A bed lies in the northwest corner, and a stove lies in the northeast.

On the stove is a frying pan.

On the shelves is a loaf of bread.

You can also see an apartment door, a backpack (empty), a dwarf banana tree, a fridge (closed) and the bed (on which are bedsheets and a pair of Central European panties) here.

>onear knickers
That's not a verb I recognize.

>gonear knickers
There seems to be no such object anywhere in the model world.

>x knickers
You can't see any such thing.

>x panties
Pink, frilly, and definitely not yours.

>take panties
Nice.

>smell panties
God, that's good.

>smell panties
God, that's good.

* * *

>gonear c-train
Train Tunnel
This underwater transit tunnel represents a feat of engineering. Its creator won the Most Illustrious Dane medal.

You can see a C-Train (in which is a wrap-around sofa) here.

>enter c-train
You get into the C-Train.

In the C-Train you can see a wrap-around sofa.

>exit
You can't get out while the train is moving.

* * *

I beg your pardon?

>r
Time passes.

You arrive in Hellerup.

>exit c-train
I only understood you as far as wanting to exit.

>leave c-train
I only understood you as far as wanting to leave.

>leave
Train Platform
The open-air train platform has a line that runs to Copenhagen every 10 minutes. There are no tickets: it is free to ride.

You can see a C-Train (in which is a wrap-around sofa) and a paper kroner here.

>rules
Rules tracing now switched on. Type "rules off" to switch it off again, or "rules all" to include even rules which do not apply.

* * *

>i
[Rule "declare everything initially unmentioned rule" applies.]
[Rule "announce items from multiple object lists rule" applies.]
[Rule "set pronouns from items from multiple object lists rule" applies.]
[Rule "before stage rule" applies.]
[Rule "sanity-check stage rule" applies.]
[Rule "instead stage rule" applies.]
[Rule "investigate player's awareness before action rule" applies.]
[Rule "player aware of his own actions rule" applies.]
[Rule "check stage rule" applies.]
[Rule "carry out stage rule" applies.]
[Rule "print empty inventory rule" applies.]
[Rule "print standard inventory rule" applies.]
You are carrying:
  a wallet
    5 kroner
    1 Uncle Sam
[Rule "after stage rule" applies.]

[Rule "investigate player's awareness after action rule" applies.]
[Rule "report stage rule" applies.]
[Rule "report other people taking inventory rule" applies.]
[Rule "last specific action-processing rule" applies.]
[Rule "A first turn sequence rule" applies.]
[Rule "every turn stage rule" applies.]
[Rule "A last turn sequence rule" applies.]
[Rule "notify score changes rule" applies.]

>r
[Rule "declare everything initially unmentioned rule" applies.]
[Rule "announce items from multiple object lists rule" applies.]
[Rule "set pronouns from items from multiple object lists rule" applies.]
[Rule "before stage rule" applies.]
[Rule "sanity-check stage rule" applies.]
[Rule "instead stage rule" applies.]
[Rule "investigate player's awareness before action rule" applies.]
[Rule "player aware of his own actions rule" applies.]
[Rule "check stage rule" applies.]
[Rule "carry out stage rule" applies.]
[Rule "after stage rule" applies.]
[Rule "investigate player's awareness after action rule" applies.]
[Rule "report stage rule" applies.]
[Rule "standard report waiting rule" applies.]
Time passes.
[Rule "last specific action-processing rule" applies.]

[Rule "A first turn sequence rule" applies.]
[Rule "every turn stage rule" applies.]
[Rule "A last turn sequence rule" applies.]
[Rule "notify score changes rule" applies.]

>r
[Rule "declare everything initially unmentioned rule" applies.]
[Rule "announce items from multiple object lists rule" applies.]
[Rule "set pronouns from items from multiple object lists rule" applies.]
[Rule "before stage rule" applies.]
[Rule "sanity-check stage rule" applies.]
[Rule "instead stage rule" applies.]
[Rule "investigate player's awareness before action rule" applies.]
[Rule "player aware of his own actions rule" applies.]
[Rule "check stage rule" applies.]
[Rule "carry out stage rule" applies.]
[Rule "after stage rule" applies.]
[Rule "investigate player's awareness after action rule" applies.]
[Rule "report stage rule" applies.]
[Rule "standard report waiting rule" applies.]
Time passes.
[Rule "last specific action-processing rule" applies.]

[Rule "A first turn sequence rule" applies.]
[Rule "every turn stage rule" applies.]
[Rule "A last turn sequence rule" applies.]
[Rule "When Hellerup Stop ends" applies.]
The C-Train departs, taking you into a tunnel.

[Rule "scene description text rule" applies.]
[Rule "notify score changes rule" applies.]

>r
[Rule "declare everything initially unmentioned rule" applies.]
[Rule "announce items from multiple object lists rule" applies.]
[Rule "set pronouns from items from multiple object lists rule" applies.]
[Rule "before stage rule" applies.]
[Rule "sanity-check stage rule" applies.]
[Rule "instead stage rule" applies.]
[Rule "investigate player's awareness before action rule" applies.]
[Rule "player aware of his own actions rule" applies.]
[Rule "check stage rule" applies.]
[Rule "carry out stage rule" applies.]
[Rule "after stage rule" applies.]
[Rule "investigate player's awareness after action rule" applies.]
[Rule "report stage rule" applies.]
[Rule "standard report waiting rule" applies.]
Time passes.
[Rule "last specific action-processing rule" applies.]

[Rule "A first turn sequence rule" applies.]
[Rule "every turn stage rule" applies.]
[Rule "A last turn sequence rule" applies.]
[Rule "notify score changes rule" applies.]

>exit
[Rule "declare everything initially unmentioned rule" applies.]
[Rule "Setting action variables for exiting" applies.]
[Rule "announce items from multiple object lists rule" applies.]
[Rule "set pronouns from items from multiple object lists rule" applies.]
[Rule "before stage rule" applies.]
[Rule "Before an actor exiting" applies.]
[Rule "sanity-check stage rule" applies.]
[Rule "instead stage rule" applies.]
[Rule "Instead of exiting when the player is in the C-Train" applies.]
You can't get out while the train is moving.

[Rule "A first turn sequence rule" applies.]
[Rule "every turn stage rule" applies.]
[Rule "A last turn sequence rule" applies.]
[Rule "notify score changes rule" applies.]

>exit c-train
I only understood you as far as wanting to exit.

>r
[Rule "declare everything initially unmentioned rule" applies.]
[Rule "announce items from multiple object lists rule" applies.]
[Rule "set pronouns from items from multiple object lists rule" applies.]
[Rule "before stage rule" applies.]
[Rule "sanity-check stage rule" applies.]
[Rule "instead stage rule" applies.]
[Rule "investigate player's awareness before action rule" applies.]
[Rule "player aware of his own actions rule" applies.]
[Rule "check stage rule" applies.]
[Rule "carry out stage rule" applies.]
[Rule "after stage rule" applies.]
[Rule "investigate player's awareness after action rule" applies.]
[Rule "report stage rule" applies.]
[Rule "standard report waiting rule" applies.]
Time passes.
[Rule "last specific action-processing rule" applies.]

[Rule "A first turn sequence rule" applies.]
[Rule "every turn stage rule" applies.]
[Rule "A last turn sequence rule" applies.]
[Rule "notify score changes rule" applies.]

>r
[Rule "declare everything initially unmentioned rule" applies.]
[Rule "announce items from multiple object lists rule" applies.]
[Rule "set pronouns from items from multiple object lists rule" applies.]
[Rule "before stage rule" applies.]
[Rule "sanity-check stage rule" applies.]
[Rule "instead stage rule" applies.]
[Rule "investigate player's awareness before action rule" applies.]
[Rule "player aware of his own actions rule" applies.]
[Rule "check stage rule" applies.]
[Rule "carry out stage rule" applies.]
[Rule "after stage rule" applies.]
[Rule "investigate player's awareness after action rule" applies.]
[Rule "report stage rule" applies.]
[Rule "standard report waiting rule" applies.]
Time passes.
[Rule "last specific action-processing rule" applies.]

[Rule "A first turn sequence rule" applies.]
[Rule "every turn stage rule" applies.]
[Rule "A last turn sequence rule" applies.]
[Rule "notify score changes rule" applies.]

>r
[Rule "declare everything initially unmentioned rule" applies.]
[Rule "announce items from multiple object lists rule" applies.]
[Rule "set pronouns from items from multiple object lists rule" applies.]
[Rule "before stage rule" applies.]
[Rule "sanity-check stage rule" applies.]
[Rule "instead stage rule" applies.]
[Rule "investigate player's awareness before action rule" applies.]
[Rule "player aware of his own actions rule" applies.]
[Rule "check stage rule" applies.]
[Rule "carry out stage rule" applies.]
[Rule "after stage rule" applies.]
[Rule "investigate player's awareness after action rule" applies.]
[Rule "report stage rule" applies.]
[Rule "standard report waiting rule" applies.]
Time passes.
[Rule "last specific action-processing rule" applies.]

[Rule "A first turn sequence rule" applies.]
[Rule "every turn stage rule" applies.]
[Rule "A last turn sequence rule" applies.]
[Rule "When Train Wait 2 ends" applies.]
You arrive in Copenhagen.

[Rule "scene description text rule" applies.]
[Rule "notify score changes rule" applies.]

>exit c-train
I only understood you as far as wanting to exit.

>exit from c-train
I only understood you as far as wanting to exit.

* * *

>rules off
[Rule "declare everything initially unmentioned rule" applies.]
Rules tracing now switched off. Type "rules" to switch it on again.

>i
You are carrying:
  a wallet
    5 kroner
    1 Uncle Sam

>i
You are carrying:
  a wallet
    5 kroner
    1 Uncle Sam

>i
You are carrying:
  a wallet
    5 kroner
    1 Uncle Sam

The C-Train departs without you.

>r
Time passes.

>l
Copenhagen Metro Station
This is the main metro station in Copenhagen. Its creator won the Best Dane of the Year Award.

Stairs lead southward and upward to the IIT Campus exit. Christiana is northwest of here: this much you know.

The Danes are very efficient: you can also take a direct route west from here to the Aarenhus Cemetery.

A small door stands in the southeast corner of the station near a fake tree.

You can see the fake tree (closed) here.

>se
(first opening the small door)

The Path
This odd little path runs out of the metro station and terminates at a promontory overlooking the bay. The ground is grassy, but the only larger vegetation is a gnarled bush.

Out in the bay is a small island.

On the gnarled bush is the bald eagle.

>purloin steak
[Purloined.]

>feed steak to eagle
The bald eagle is perfectly sated.

>ride eagle
The bald eagle cannot be ridden.

>mount eagle
The bald eagle cannot be ridden.

* * *

>gonear cemetery
Aarenhus Cemetery
Dark paths run here and there among the marble tombs. Some trees provide relaxing shade, and flowers bloom here and there.

You can see a red flower, a white flower, a blue flower and a yellow flower here.

>rela
That's not a verb I recognize.

>eat
(the wallet)
Foolish American, have you truly mistaken the wallet for food?

>take flower
Which do you mean, the red flower, the white flower, the blue flower or the yellow flower?

>red
Taken.

>l
Aarenhus Cemetery
Dark paths run here and there among the marble tombs. Some trees provide relaxing shade, and flowers bloom here and there.

You can see a white flower, a blue flower and a yellow flower here.

I beg your pardon?

>i
You are carrying:
  a red flower
  a wallet
    2 kroner
    1 Uncle Sam

This seems like a terrific place to relax.

>x trees
Strong and hardy. It's macabre, but bones make excellent fertilizer.

>x tomb
Your attention rests on a tomb of pale white marble with pinkish streaks.

>x the
What do you want to examine?

>tomb
Your attention rests on a tomb of blue-gray marble with pinkish streaks.

>x flower
(the red flower)
Sweet-smelling.

>x white
The color of fine linen.

>x blue
As blue as the sky.

This seems like a superb place to relax.

>x yello
You can't see any such thing.

>x yellow
The yellow petals crinkle at the edges.

>relax
You take a deep breath of Danish air, and let it out slowly.

[Your score has just gone up by one point.]

>relax
You take a deep breath of Danish air, and let it out slowly.

>g
You take a deep breath of Danish air, and let it out slowly.

>g
You take a deep breath of Danish air, and let it out slowly.

>g
You take a deep breath of Danish air, and let it out slowly.

This seems like a superb place to relax.

>g
You take a deep breath of Danish air, and let it out slowly.

>i
You are carrying:
  a red flower
  a wallet
    2 kroner
    1 Uncle Sam

* * *

>gonear cemetery
Aarenhus Cemetery
Dark paths run here and there among the marble tombs. Some trees provide relaxing shade, and flowers bloom here and there.

You can see a red flower, a white flower, a blue flower and a yellow flower here.

>wait / wait / wait / wait / wait / wait / wait / wait
I only understood you as far as wanting to wait.

>wait. wait. g. g. g. g. g. g. g. g. g.
Time passes.

This seems like a excellent place to relax.

Time passes.

Time passes.

This seems like a excellent place to relax.

Time passes.

This seems like a superb place to relax.

Time passes.

Time passes.

This seems like a excellent place to relax.

Time passes.

Time passes.

This seems like a excellent place to relax.

Time passes.

Time passes.

This seems like a perfect place to relax.

Time passes.

This seems like a superb place to relax.

>rela
That's not a verb I recognize.

>relax
You take a deep breath of Danish air, and let it out slowly.

[Your score has just gone up by one point.]

>wait. wait. g. g. g. g. g. g. g. g. g.
Time passes.

Time passes.

Time passes.

Time passes.

Time passes.

Time passes.

Time passes.

Time passes.

Time passes.

Time passes.

Time passes.

>gonear cemetery
Aarenhus Cemetery
Dark paths run here and there among the marble tombs. Some trees provide relaxing shade, and flowers bloom here and there.

You can see a red flower, a white flower, a blue flower and a yellow flower here.

>wait. wait. g. g. g. g. g. g. g. g. g.
Time passes.

Time passes.

Time passes.

Time passes.

Time passes.

Time passes.

Time passes.

Time passes.

Time passes.

Time passes.

Time passes.

* * *

>gonear cemetry
There seems to be no such object anywhere in the model world.

>purloin pack
[Purloined.]

>gonear flower
Which do you mean, the red flower, the white flower, the blue flower or the yellow flower?

>red
Aarenhus Cemetery
Dark paths run here and there among the marble tombs. Some trees provide relaxing shade, and flowers bloom here and there.

You can see a red flower, a white flower, a blue flower and a yellow flower here.

>take all
red flower: Taken.
white flower: (putting the wallet into the backpack to make room)
Taken.
blue flower: (putting the red flower into the backpack to make room)
Taken.
yellow flower: (putting the white flower into the backpack to make room)
Taken.

>x tree
Strong and hardy. It's macabre, but bone makes excellent fertilizer.

>relax
You take a deep breath and let it out slowly. Tension disappears from your body.

[Your score has just gone up by one point.]

>relax
You take a deep breath and let it out slowly. Tension disappears from your body.

>relax
You take a deep breath and let it out slowly. Tension disappears from your body.

>x
What do you want to examine?

>tree
compass (659083) 
  the north
  the northeast
  the northwest
  the south
  the southeast
  the southwest
  the east
  the west
  the up
  the down
  the inside
  the outside
(darkness object) (659115) 
(Inform Parser) (659147) 
(Inform Library) (659179) 
(property_numberspace_forcer) (659211) 
(ValuePropertyHolder_43) (659275) 
(ValuePropertyHolder_47) (659307) 
Limbo (660459) 
  the bald eagle
  the friendly bird
Hellerup (660555) 
Apartment (660587) 
  an apartment door
  a rug
  a stove
    a frying pan
  a round window
  some shelves
    a loaf of bread
  a dwarf banana tree
  a fridge (closed)
    a piece of cheese
    a steak
    a glass bottle (closed)
      some Dankdrinke
  the bed
    bedsheets
    a pair of Central European panties
Hellerup Strandvejen (661291) 
  some row houses
  a street vendor
    a long coat (being worn)
    a fingerless glove (being worn)
    a pair of trousers (being worn)
    a pair of sneakers (being worn)
  a wheelbarrow
    a pile of herring
    a mound of herring
handle (661611) 
pocket (661643) 
  a fistful of herring
Dock (661707) 
  a rowboat
    the herring crate
      a wretched bird
  a rope
Train Platform (661867) 
  a wall sign
  a paper kroner
Train Tunnel (661963) 
  a C-Train
    a wrap-around sofa
Copenhagen (662059) 
Copenhagen Metro Station (662091) 
  a small door
  the fake tree
IIT Campus (662155) 
  Ana
  a stone bench
Christiana Main Street (662251) 
  a pusher
  a pushcart
    a marijuana joint
Aarenhus Cemetery (662379) 
  yourself
    a yellow flower
    a blue flower
    a backpack (open)
      a white flower
      a red flower
      a wallet
        5 kroner
        1 Uncle Sam
  some marble tombs
  some trees
The Path (662603) 
  a gnarled bush
small sign (662699) 
Belly of the Tree (662731) 
Island of Technique (662763) 
  a monk
    a gray robe (being worn)

I beg your pardon?

>x tree
Strong and hardy. It's macabre, but bone makes excellent fertilizer.

>tree
compass (659083) 
  the north
  the northeast
  the northwest
  the south
  the southeast
  the southwest
  the east
  the west
  the up
  the down
  the inside
  the outside
(darkness object) (659115) 
(Inform Parser) (659147) 
(Inform Library) (659179) 
(property_numberspace_forcer) (659211) 
(ValuePropertyHolder_43) (659275) 
(ValuePropertyHolder_47) (659307) 
Limbo (660459) 
  the bald eagle
  the friendly bird
Hellerup (660555) 
Apartment (660587) 
  an apartment door
  a rug
  a stove
    a frying pan
  a round window
  some shelves
    a loaf of bread
  a dwarf banana tree
  a fridge (closed)
    a piece of cheese
    a steak
    a glass bottle (closed)
      some Dankdrinke
  the bed
    bedsheets
    a pair of Central European panties
Hellerup Strandvejen (661291) 
  some row houses
  a street vendor
    a long coat (being worn)
    a fingerless glove (being worn)
    a pair of trousers (being worn)
    a pair of sneakers (being worn)
  a wheelbarrow
    a pile of herring
    a mound of herring
handle (661611) 
pocket (661643) 
  a fistful of herring
Dock (661707) 
  a rowboat
    the herring crate
      a wretched bird
  a rope
Train Platform (661867) 
  a wall sign
  a paper kroner
Train Tunnel (661963) 
Copenhagen (662059) 
Copenhagen Metro Station (662091) 
  a C-Train
    a wrap-around sofa
  a small door
  the fake tree
IIT Campus (662155) 
  Ana
  a stone bench
Christiana Main Street (662251) 
  a pusher
  a pushcart
    a marijuana joint
Aarenhus Cemetery (662379) 
  yourself
    a yellow flower
    a blue flower
    a backpack (open)
      a white flower
      a red flower
      a wallet
        5 kroner
        1 Uncle Sam
  some marble tombs
  some trees
The Path (662603) 
  a gnarled bush
small sign (662699) 
Belly of the Tree (662731) 
Island of Technique (662763) 
  a monk
    a gray robe (being worn)

* * *

>gonear commissary
Which do you mean, the Socialist Money Commissary or Commissary Counter?

>money
Copenhagen Metro Station
This is the main metro station in Copenhagen. Its creator won the Best Dane of the Year Award.

Stairs lead southward and upward to the IIT Campus exit. Christiana is northwest of here: this much you know.

The Danes are very efficient: you can also take a direct route west from here to the Aarenhus Cemetery.

A small door stands in the southeast corner of the station near a fake tree.

You can see a Socialist Money Commissary (empty) here.

>enter commissary
That's not something you can enter.

>gonear counter
Commissary Counter
The inside of the commissary is a bit cramped, but the lighting is gentle and there is air-conditioning. 

You can see a clerk, a one-kroner note, a two-kroner note and a three-kroner note here.

>take one-kroner note
Ignorant American! Under Socialism, everyone has a job to do - and the clerk's job is to do that for you.

The clerk picks up the one-kroner note.

The clerk gives the one-kroner note to you.

>i
You are carrying:
  a wallet
    6 kroner
    1 Uncle Sam

>take all
two-kroner note: Ignorant American! Under Socialism, everyone has a job to do - and the clerk's job is to do that for you.

The clerk picks up the two-kroner note.

The clerk gives the two-kroner note to you.
three-kroner note: Ignorant American! Under Socialism, everyone has a job to do - and the clerk's job is to do that for you.

The clerk picks up the three-kroner note.

The clerk gives the three-kroner note to you.

>i
You are carrying:
  a wallet
    11 kroner
    1 Uncle Sam

>x clerk
She gives you the smile of a true believer.

>i
You are carrying:
  a wallet
    11 kroner
    1 Uncle Sam

>l
Commissary Counter
The inside of the commissary is a bit cramped, but the lighting is gentle and there is air-conditioning. 

You can see a clerk here.

>talk clerk
That's not a verb I recognize.

>ask clerk
(for the wallet)
(the clerk first taking the wallet)
The clerk has better things to do.

>ask clerk for money
(the clerk first taking 11 kroner)
The clerk has better things to do.

>ask clerk for cash
(the clerk first taking 11 kroner)
The clerk has better things to do.

>restart
Are you sure you want to restart?

>y
herring crate has no description.
brown jumpsuit has no description.
gold apron has no description.
one-kroner note has no description.
two-kroner note has no description.
three-kroner note has no description.
gray robe has no description.

It is the Year of Our Lord MMXVIII. You have arrived in the Danish city of Copenhagen to pursue a master's degree. You found an apartment for let in the suburb of Hellerup, and promptly moved in. The place isn't much, but for the next two years it's home. 

PREPARE YOUR SPIRIT FOR . . .

RYAN QUEST 2
An Interactive Fiction by Maxwell Joslyn
Release 1 / Serial number 181220 / Inform 7 build 6M62 (I6/v6.33 lib 6/12N) SD

Apartment
Your apartment is a cheery little cube. On the east wall is a round window. A woven rug adorns the floor in the middle of the room. Along the west wall are a fridge and some shelves. A bed lies in the northwest corner, and a stove lies in the northeast.

On the stove is a frying pan.

On the shelves is a loaf of bread.

You can also see an apartment door, a backpack (empty), a dwarf banana tree, a fridge (closed) and the bed (on which are bedsheets and a pair of Central European panties) here.

>gonear counter
Commissary Counter
The inside of the commissary is a bit cramped, but the lighting is gentle and there is air-conditioning. 

You can see a clerk, a one-kroner note, a two-kroner note and a three-kroner note here.

>buy one-kroner note
You pay 1 kroner for the one-kroner note, leaving yourself with 4 kroner.

I beg your pardon?

>i
You are carrying:
  a one-kroner note
  a wallet
    4 kroner
    1 Uncle Sam

* * *

>gonear counter
Commissary Counter
The inside of the commissary is a bit cramped, but the lighting is gentle and there is air-conditioning. 

You can see a clerk, a one-kroner note, a two-kroner note and a three-kroner note here.

>buy one-kroner note
Ignorant American! Under Socialism, everyone has a job to do - and the clerk's job is to hand you that one-kroner note.

The clerk picks up the one-kroner note.

The clerk gives the one-kroner note to you.

>i
You are carrying:
  a wallet
    6 kroner
    1 Uncle Sam

* * *

>gonear crate
Dock
This is a shabby little dock used for the fishing trade. At the end of the dock, a little rowboat, moored with a rope, bobs up and down. In the rowboat is a large crate, atop which sits a bird.

>enter crate
That's not something you can enter.

* * *

>gonear crate
Dock
This is a shabby little dock used for the fishing trade. At the end of the dock, a little rowboat, moored with a rope, bobs up and down. In the rowboat is a large crate, atop which sits a bird.

>x crate
It's got to be loaded with herring.

On the herring crate is a wretched bird.

>enter crate
That's not something you can enter.

>get on crate
That's not something you can enter.

>move bird to limbo
You can't see any such thing.

>purloin pile
[Purloined.]

>feed pile to bird
The wretched bird regards you warily, then opens its beak and snaps up the pile of herring. It swallows in one gulp.

You see a flash of brilliance in its black, beady eyes. Then it caws, and flies off in the direction of Copenhagen.

You feel strangely proud.

[Your score has just gone up by one point.]

>enter crate
That's not something you can enter.

* * *

>gonear eagle
Limbo
You can see the bald eagle and the friendly bird here.

>eat eagle
Foolish American, have you truly mistaken the bald eagle for food?

>feed steak to bird
You can't see any such thing.

>purloin steak
[Purloined.]

* * *

>i
You are carrying:
  a wallet
    5 kroner
    1 Uncle Sam

>purloin panties
[Purloined.]

>give panties to friendly
Unlike you, the friendly bird is entirely unmotivated by sexy underwear.

>give panties to eagle
The bald eagle is perfectly sated.

* * *

>gonear eagle
Limbo
You can see the bald eagle and the friendly bird here.

>ride eage
You can't see any such thing.

>mount eagle
The bald eagle cannot be ridden.

>ride eagle
The bald eagle cannot be ridden.

I beg your pardon?

* * *

>gonear eagle
Limbo
You can see the bald eagle and the friendly bird here.

>ride friendly
The friendly bird is too small to ride.

>ride agle
You can't see any such thing.

>ride eagle
The eagle shrieks, and dives off the promontory with you on its back. As you cling for dear life, it swoops down to skim the water, then soars out above the bay.

The view out here is breathtaking. Twisting your head around, you can look back and see all of Copenhagen laid out like a continental breakfast.

Island of Technique
This little island is no tropical paradise. It's more like someone carved a chunk off of Scotland and dropped it at the edge of the bay.

* * *

>gonear fake tree
Copenhagen Metro Station
This is the main metro station in Copenhagen. Its creator won the Best Dane of the Year Award.

Stairs lead southward and upward to the IIT Campus exit. Christiana is northwest of here: this much you know.

The Danes are very efficient: you can also take a direct route west from here to the Aarenhus Cemetery.

A small door stands in the southeast corner of the station near a fake tree.

You can see a Socialist Money Commissary (empty) here.

>enter commissary
That's not something you can enter.

* * *

>gonear fake tree
Copenhagen Metro Station
This is the main metro station in Copenhagen. Its creator won the Best Dane of the Year Award.

Stairs lead southward and upward to the IIT Campus exit. Christiana is northwest of here: this much you know.

The Danes are very efficient: you can also take a direct route west from here to the Aarenhus Cemetery.

A small door stands in the southeast corner of the station near a fake tree.

You can see a Socialist Money Commissary (empty) here.

>i
You are carrying:
  a wallet
    5 kroner
    1 Uncle Sam

>x tree
You see nothing special about the fake tree.

* * *

>gonear fake tree
Copenhagen Metro Station
This is the main metro station in Copenhagen. Its creator won the Best Dane of the Year Award.

Stairs lead southward and upward to the IIT Campus exit. Christiana is northwest of here: this much you know.

The Danes are very efficient: you can also take a direct route west from here to the Aarenhus Cemetery.

A small door stands in the southeast corner of the station near a fake tree.

You can see a Socialist Money Commissary (empty) here.

>purloin joint
[Purloined.]

>smoke joint
You hit it and don't quit it. Your War-on-Drugs work ethic erases that joint from existence.

Now you're baked.

>l
Copenhagen Metro Station
This is the main metro station in Copenhagen. Its creator won the Best Dane of the Year Award.

Stairs lead southward and upward to the IIT Campus exit. Christiana is northwest of here: this much you know.

The Danes are very efficient: you can also take a direct route west from here to the Aarenhus Cemetery.

A small door stands in the southeast corner of the station near a fake tree.

You can see the fake tree (closed) here.

>l tree
A huge plastic palm tree which 'grows' from a wicker basket. It's fifteen feet tall and twenty feet around.

>unlock tree
(with the wallet)
That's unlocked at the moment.

>enter tree
That's not something you can enter.

>open tree
You open the fake tree.

The C-Train arrives.

>enter tree
That's not something you can enter.

* * *

>gonear fake tree
Copenhagen Metro Station
This is the main metro station in Copenhagen. Its creator won the Best Dane of the Year Award.

Stairs lead southward and upward to the IIT Campus exit. Christiana is northwest of here: this much you know.

The Danes are very efficient: you can also take a direct route west from here to the Aarenhus Cemetery.

A small door stands in the southeast corner of the station near a fake tree.

You can see a Socialist Money Commissary (empty) here.

>x sign
The hand-lettered sign reads, "In case you haven't noticed, you've gotten 0 points so far."

* * *

>gonear flower
Which do you mean, the red flower, the white flower, the blue flower or the yellow flower?

* * *

>red
Aarenhus Cemetery
Dark paths run here and there among the marble tombs. Some trees provide relaxing shade, and flowers bloom here and there.

You can see a red flower, a white flower, a blue flower and a yellow flower here.

>take all
red flower: Taken.
white flower: Taken.
blue flower: You're carrying too many things already.
yellow flower: You're carrying too many things already.

>drop all
white flower: Dropped.
red flower: Dropped.
wallet: Dropped.

>purloin pack
[Purloined.]

>ake all
That's not a verb I recognize.

>take all
wallet: Taken.
red flower: Taken.
white flower: (putting the wallet into the backpack to make room)
Taken.
blue flower: (putting the red flower into the backpack to make room)
Taken.
yellow flower: (putting the white flower into the backpack to make room)
Taken.
5 kroner: No need to do anything with that until you want to buy something.
1 Uncle Sam: (putting the blue flower into the backpack to make room)
Taken.

>i
You are carrying:
  1 Uncle Sam
  a yellow flower
  a backpack (open)
    a blue flower
    a white flower
    a red flower
    a wallet
      5 kroner

>l
Aarenhus Cemetery
Dark paths run here and there among the marble tombs. Some trees provide relaxing shade.

>x trees
Strong and hardy. It's macabre, but bone makes excellent fertilizer.

>x tombs
Your attention rests on a tomb of pale white marble with silvery streaks.

>x marble
Your attention rests on a tomb of blue-gray marble with pinkish streaks.

>x tomb
Your attention rests on a tomb of gray-green marble with dark brown streaks.

>x marble
Your attention rests on a tomb of reddish-purple marble with pinkish streaks.

>x marble
Your attention rests on a tomb of gray-green marble with dark brown streaks.

>x trees
Strong and hardy. It's macabre, but bone makes excellent fertilizer.

>x tree
You can't see any such thing.

* * *

>gonear flower
Which do you mean, the red flower, the white flower, the blue flower or the yellow flower?

>red flower
Aarenhus Cemetery
Dark paths run here and there among the marble tombs. Some trees provide relaxing shade, and white flowers bloom here and there.

You can see a red flower, a white flower, a blue flower and a yellow flower here.

>relax
Here in the cemetery, surrounded by memories of Danes past, you take a deep breath and let it out slowly. Tension disappears from your body.

[You have revealed a secret elsewhere.]
You pause for a moment and appreciate the silence. Tension is evicted from your body with extreme prejudice.

* * *

>gonear iit
IIT Campus
The campus is pretty sleepy in the summer. A construction crew works below the bell tower, but the only student you see is Ana.

You can see Ana and a stone bench here.

>sit on benh
You can't see any such thing.

>sit on bench
You get onto the stone bench.

>push button
Nothing obvious happens.

>press button. g. g. g. g. g. g. g. g.
From somewhere nearby, a voice yells, "F!"
From somewhere nearby, a voice yells, "E!"
From somewhere nearby, a voice yells, "E!"
From somewhere nearby, a voice yells, "D!"
From somewhere nearby, a voice yells, "B!"
From somewhere nearby, a voice yells, "I!"
From somewhere nearby, a voice yells, "R!"
From somewhere nearby, a voice yells, "D!"
[Your score has just gone up by one point.]

Nothing appears to happen.
;-)

>g
Nothing appears to happen.
;-)

>g
Nothing appears to happen.
;-)

* * *

>gonear iit
IIT Campus
The campus is pretty sleepy in the summer. A construction crew works below the bell tower, but the only student you see is Ana.

You can see Ana and a stone bench here.

>x bench
Effortlessly square.

>push button
Nothing obvious happens.

>eat button
Foolish American, have you truly mistaken the button for food?

* * *

>gonear joint
Christiana Main Street
This street is lined with drug pushers, filled with tourists, dotted with hippies, and sprinkled with musicians.

You can see a pusher and a pushcart (on which is a marijuana joint) here.

The pusher eyes your wallet.

>buy joint
You pay 2 kroner for the marijuana joint, leaving yourself with 3 kroner.

The pusher eyes your wallet.

>w
You can't go that way.

The pusher eyes your wallet.

I beg your pardon?

>e
You can't go that way.

The pusher eyes your marijuana joint.

>n
You can't go that way.

The pusher eyes your wallet.

>s
You can't go that way.

The pusher eyes your marijuana joint.

>se
Copenhagen Metro Station
This is the main metro station in Copenhagen. Its creator won the Best Dane of the Year Award.

Stairs lead southward and upward to the IIT Campus exit. Christiana is northwest of here: this much you know.

The Danes are very efficient: you can also take a direct route west from here to the Aarenhus Cemetery.

A small door stands in the southeast corner of the station near a fake tree.

You can see the fake tree here.

The C-Train arrives.

>open tre
You can't see any such thing.

>open tree
It seems to be locked.

>x tre
You can't see any such thing.

>x tree
A plastic palm tree. It's huge: fifteen feet tall and twenty feet around. It 'grows' from an inch-thick disc of marble which is set into the floor of the station, disrupting the pattern of tiles around it.

* * *

>gonear joint
Christiana Main Street
This street is lined with drug pushers, filled with tourists, dotted with hippies, and sprinkled with musicians.

You can see a pusher and a pushcart (on which is a marijuana joint) here.

The pusher eyes your wallet.

>buy joint. smoke joint
You pay 2 kroner for the marijuana joint, leaving yourself with 3 kroner.

The pusher eyes your marijuana joint.

You hit it and don't quit it. Your War-on-Drugs work ethic erases that joint from existence.

Now you're baked.

The pusher eyes your wallet.

>i
You are carrying:
  a wallet
    3 kroner
    1 Uncle Sam

The pusher eyes your wallet.

>l
Christiana Main Street
This street is lined with drug pushers, filled with tourists, dotted with hippies, and sprinkled with musicians.

You can see a pusher and a pushcart here.

The pusher eyes your wallet.

>l pusher
Busily rolling another mondo joint.

The pusher eyes your wallet.

>e
You can't go that way.

The pusher eyes your wallet.

>w
You can't go that way.

The pusher eyes your wallet.

>s
You can't go that way.

The pusher eyes your wallet.

>n
You can't go that way.

The pusher eyes your wallet.

>nw
You can't go that way.

The pusher eyes your wallet.

>se
Copenhagen Metro Station
This is the main metro station in Copenhagen. Its creator won the Best Dane of the Year Award.

Stairs lead southward and upward to the IIT Campus exit. Christiana is northwest of here: this much you know.

The Danes are very efficient: you can also take a direct route west from here to the Aarenhus Cemetery.

A small door stands in the southeast corner of the station near a fake tree.

You can see the fake tree (closed) here.

>open tre
You can't see any such thing.

* * *

>open tree
It seems to be locked.

>go door
(first opening the small door)

The Path
This odd little path runs out of the metro station and terminates at a promontory overlooking the bay. The ground is grassy, but the only larger vegetation is a gnarled bush.

Out in the bay is a small island.

>gonear wretched bird
Dock
This is a shabby little dock used for the fishing trade. At the end of the dock, a little rowboat, moored with a rope, bobs up and down. In the rowboat is a large crate, atop which sits a bird.

>purloin herring
(the herring crate)
[Purloined.]

>give herring to bird
The wretched bird turns its nose up at the herring crate.

>purloin all
[Purloined.]
[Purloined.]
[Purloined.]
[Purloined.]
[Can't move Dock: it would contain itself.]
[Purloined.]
[Purloined.]
[Purloined.]
[Purloined.]
[Purloined.]
[Purloined.]
[Purloined.]
[Purloined.]
[Purloined.]
[Purloined.]
[Purloined.]
[Purloined.]
[Purloined.]
[Purloined.]
[Purloined.]
[Purloined.]
[Purloined.]
[Purloined.]
[Purloined.]
[Purloined.]
[Purloined.]
[Purloined.]
[Purloined.]
[Purloined.]
[Purloined.]
[Purloined.]
[Can't move handle: it's part of the fridge.]
[Can't move pocket: it's part of the long coat.]
[Purloined.]
[Purloined.]
[Purloined.]
[Purloined.]
[Purloined.]
[Purloined.]
[Purloined.]
[Purloined.]
[Purloined.]
[Purloined.]
[Purloined.]
[Purloined.]
[Purloined.]
[Purloined.]
[Purloined.]
[Purloined.]
[Purloined.]
[Purloined.]
[Purloined.]
[Purloined.]
[Purloined.]
[Purloined.]
[Can't move small sign: it's part of the small door.]
[Purloined.]
[Purloined.]
[Purloined.]
[Purloined.]
[Purloined.]
[Purloined.]
[Purloined.]
[Purloined.]
[Purloined.]
[Purloined.]
[Purloined.]
[Purloined.]
[Purloined.]
[Purloined.]
[Purloined.]
[Purloined.]
[Purloined.]
[Purloined.]
[Purloined.]
[Purloined.]
[Purloined.]
[Purloined.]
[Purloined.]

>give pile to bird
Who do you mean, the friendly bird or the wretched bird?

>wretched
The wretched bird regards you warily, then opens its beak and snaps up the pile of herring. It swallows in one gulp.

You see a flash of brilliance in its black, beady eyes. Then it caws, and flies off in the direction of Copenhagen.

You feel strangely proud.

The pusher eyes your piece of cheese.

[Your score has just gone up by one point.]

>i
You are carrying:
  the outside
  the inside
  the down
  the up
  the west
  the east
  the southwest
  the southeast
  the south
  the northwest
  the northeast
  the north
  a small door
  a gnarled bush
  some trees
  some marble tombs
  some row houses
  some shelves
  a round window
  a stove
  a rug
  a monk
  an Island of Technique (providing light)
  The Path (providing light)
  a yellow flower
  a blue flower
  a white flower
  a red flower
  Aarenhus Cemetery (providing light)
  a marijuana joint
  a pushcart
  a pusher
  Christiana Main Street (providing light)
  a stone bench
  Ana
  IIT Campus (providing light)
  the fake tree (closed and locked)
  Copenhagen Metro Station (providing light)
  Copenhagen
  a wrap-around sofa
  a C-Train
  Train Tunnel (providing light)
  a paper kroner
  a Train Platform (providing light)
  a fistful of herring
  a mound of herring
  a wheelbarrow
  a street vendor
  Hellerup Strandvejen (providing light)
  an apartment door
  a pair of Central European panties
  bedsheets
  the bed
  some Dankdrinke
  a glass bottle (closed)
  a steak
  a piece of cheese
  a fridge (closed)
  a dwarf banana tree
  a loaf of bread
  a frying pan
  a backpack (open but empty)
  an Apartment (providing light)
  Hellerup
  the bald eagle
  Limbo (providing light)
  a rope
  a rowboat
  1 Uncle Sam
  3 kroner
  the herring crate
  a wallet

The pusher eyes your street vendor.

>all
That's not a verb I recognize.

>i
You are carrying:
  the outside
  the inside
  the down
  the up
  the west
  the east
  the southwest
  the southeast
  the south
  the northwest
  the northeast
  the north
  a small door
  a gnarled bush
  some trees
  some marble tombs
  some row houses
  some shelves
  a round window
  a stove
  a rug
  a monk
  an Island of Technique (providing light)
  The Path (providing light)
  a yellow flower
  a blue flower
  a white flower
  a red flower
  Aarenhus Cemetery (providing light)
  a marijuana joint
  a pushcart
  a pusher
  Christiana Main Street (providing light)
  a stone bench
  Ana
  IIT Campus (providing light)
  the fake tree (closed and locked)
  Copenhagen Metro Station (providing light)
  Copenhagen
  a wrap-around sofa
  a C-Train
  Train Tunnel (providing light)
  a paper kroner
  a Train Platform (providing light)
  a fistful of herring
  a mound of herring
  a wheelbarrow
  a street vendor
  Hellerup Strandvejen (providing light)
  an apartment door
  a pair of Central European panties
  bedsheets
  the bed
  some Dankdrinke
  a glass bottle (closed)
  a steak
  a piece of cheese
  a fridge (closed)
  a dwarf banana tree
  a loaf of bread
  a frying pan
  a backpack (open but empty)
  an Apartment (providing light)
  Hellerup
  the bald eagle
  Limbo (providing light)
  a rope
  a rowboat
  1 Uncle Sam
  3 kroner
  the herring crate
  a wallet

The vendor grins cheerfully.

The pusher eyes your monk.

I beg your pardon?

>l
Dock
This is a shabby little dock used for the fishing trade. At the end of the dock, a little rowboat, moored with a rope, bobs up and down. In the rowboat is a large crate, atop which sits a bird.

The vendor taps his foot.

The pusher eyes your stove.

>l
Dock
This is a shabby little dock used for the fishing trade. At the end of the dock, a little rowboat, moored with a rope, bobs up and down. In the rowboat is a large crate, atop which sits a bird.

The vendor grins cheerfully.

The pusher eyes your 3 kroner.

>l
Dock
This is a shabby little dock used for the fishing trade. At the end of the dock, a little rowboat, moored with a rope, bobs up and down. In the rowboat is a large crate, atop which sits a bird.

The pusher eyes your frying pan.

>l
Dock
This is a shabby little dock used for the fishing trade. At the end of the dock, a little rowboat, moored with a rope, bobs up and down. In the rowboat is a large crate, atop which sits a bird.

The pusher eyes your Ana.

>s
That's not a verb I recognize.

>i
You are carrying:
  the outside
  the inside
  the down
  the up
  the west
  the east
  the southwest
  the southeast
  the south
  the northwest
  the northeast
  the north
  a small door
  a gnarled bush
  some trees
  some marble tombs
  some row houses
  some shelves
  a round window
  a stove
  a rug
  a monk
  an Island of Technique (providing light)
  The Path (providing light)
  a yellow flower
  a blue flower
  a white flower
  a red flower
  Aarenhus Cemetery (providing light)
  a pushcart
    a marijuana joint
  a pusher
  Christiana Main Street (providing light)
  a stone bench
  Ana
  IIT Campus (providing light)
  the fake tree (closed and locked)
  Copenhagen Metro Station (providing light)
  Copenhagen
  a wrap-around sofa
  Train Tunnel (providing light)
  a paper kroner
  a Train Platform (providing light)
  a fistful of herring
  a mound of herring
  a wheelbarrow
  a street vendor
  Hellerup Strandvejen (providing light)
  an apartment door
  a pair of Central European panties
  bedsheets
  the bed
  some Dankdrinke
  a glass bottle (closed)
  a steak
  a piece of cheese
  a fridge (closed)
  a dwarf banana tree
  a loaf of bread
  a frying pan
  a backpack (open but empty)
  an Apartment (providing light)
  Hellerup
  the bald eagle
  Limbo (providing light)
  a rope
  a rowboat
  1 Uncle Sam
  3 kroner
  the herring crate
  a wallet

The pusher eyes your steak.

>kiss ana
She slaps the kiss right off your lips.

The vendor winks at you.

The pusher eyes your marble tombs.

>give ana a flower
(the yellow flower)
Ana sighs and kisses your cheek. She strolls over to the bench, and sits down to gaze at the flower.

The pusher eyes your pushcart.

[Your score has just gone up by one point.]

>x ana
A Czech girl. Starting next week, she's your TA for Introductory Programming. Starting last night, she's your lover.

The vendor grins cheerfully.

The pusher eyes your wrap-around sofa.

>i
You are carrying:
  the outside
  the inside
  the down
  the up
  the west
  the east
  the southwest
  the southeast
  the south
  the northwest
  the northeast
  the north
  a small door
  a gnarled bush
  some trees
  some marble tombs
  some row houses
  some shelves
  a round window
  a stove
  a rug
  a monk
  an Island of Technique (providing light)
  The Path (providing light)
  a blue flower
  a white flower
  a red flower
  Aarenhus Cemetery (providing light)
  a pushcart
    a marijuana joint
  a pusher
  Christiana Main Street (providing light)
  a stone bench
    Ana
  IIT Campus (providing light)
  the fake tree (closed and locked)
  Copenhagen Metro Station (providing light)
  Copenhagen
  a wrap-around sofa
  Train Tunnel (providing light)
  a paper kroner
  a Train Platform (providing light)
  a fistful of herring
  a mound of herring
  a wheelbarrow
  a street vendor
  Hellerup Strandvejen (providing light)
  an apartment door
  a pair of Central European panties
  bedsheets
  the bed
  some Dankdrinke
  a glass bottle (closed)
  a steak
  a piece of cheese
  a fridge (closed)
  a dwarf banana tree
  a loaf of bread
  a frying pan
  a backpack (open but empty)
  an Apartment (providing light)
  Hellerup
  the bald eagle
  Limbo (providing light)
  a rope
  a rowboat
  1 Uncle Sam
  3 kroner
  the herring crate
  a wallet

The vendor taps his foot.

The pusher eyes your shelves.

* * *

I beg your pardon?

>gonear ana
Dock
This is a shabby little dock used for the fishing trade. At the end of the dock, a little rowboat, moored with a rope, bobs up and down. In the rowboat is a large crate, atop which sits a bird.

The vendor grins cheerfully.

The pusher eyes your pair of Central European panties.

>x ana
A Czech girl. Starting next week, she's your TA for Introductory Programming. Starting last night, she's your lover.

The pusher eyes your trees.

>touch ana
You caress her, and she rubs her head against your hand.

The pusher eyes your fistful of herring.

>e
That's not a verb I recognize.

>w
That's not a verb I recognize.

>s
That's not a verb I recognize.

>n
That's not a verb I recognize.

>l
Dock
This is a shabby little dock used for the fishing trade. At the end of the dock, a little rowboat, moored with a rope, bobs up and down. In the rowboat is a large crate, atop which sits a bird.

The pusher eyes your monk.

>e
That's not a verb I recognize.

* * *

>w
That's not a verb I recognize.

>w
That's not a verb I recognize.

>gonear vendor
Dock
This is a shabby little dock used for the fishing trade. At the end of the dock, a little rowboat, moored with a rope, bobs up and down. In the rowboat is a large crate, atop which sits a bird.

The pusher eyes your glass bottle.

>gonear train
Which do you mean, the Train Platform, Train Tunnel or the C-Train?

>c-train
[** Programming error: tried to "move" yourself to Train Tunnel, which would make a loop: yourself in Train Tunnel in yourself **]

The Dock
The pusher eyes your wrap-around sofa.

>gonera dick
That's not a verb I recognize.

>i
You are carrying:
  the outside
  the inside
  the down
  the up
  the west
  the east
  the southwest
  the southeast
  the south
  the northwest
  the northeast
  the north
  a small door
  a gnarled bush
  some trees
  some marble tombs
  some row houses
  some shelves
  a round window
  a stove
  a rug
  a monk
  an Island of Technique (providing light)
  The Path (providing light)
  a blue flower
  a white flower
  a red flower
  Aarenhus Cemetery (providing light)
  a pushcart
    a marijuana joint
  a pusher
  Christiana Main Street (providing light)
  a stone bench
    Ana
  IIT Campus (providing light)
  the fake tree (closed and locked)
  Copenhagen Metro Station (providing light)
  Copenhagen
  a wrap-around sofa
  Train Tunnel (providing light)
  a paper kroner
  a Train Platform (providing light)
  a fistful of herring
  a mound of herring
  a wheelbarrow
  a street vendor
  Hellerup Strandvejen (providing light)
  an apartment door
  a pair of Central European panties
  bedsheets
  the bed
  some Dankdrinke
  a glass bottle (closed)
  a steak
  a piece of cheese
  a fridge (closed)
  a dwarf banana tree
  a loaf of bread
  a frying pan
  a backpack (open but empty)
  an Apartment (providing light)
  Hellerup
  the bald eagle
  Limbo (providing light)
  a rope
  a rowboat
  1 Uncle Sam
  3 kroner
  the herring crate
  a wallet

The pusher eyes your wallet.

>island
That's not a verb I recognize.

>x island
This little island is no tropical paradise. It's more like someone carved a chunk off of Scotland and dropped it at the edge of the bay. Foggy, muddy, and riddled with trees.

The pusher eyes your white flower.

>restart
Are you sure you want to restart?

>y
wallet has no description.
row houses has no description.
herring crate has no description.
paper kroner has no description.
fake tree has no description.
monk has no description.
gray robe has no description.

It is the Year of Our Lord MMXVIII. You have arrived in the Danish city of Copenhagen to pursue a master's degree. You found an apartment for let in the suburb of Hellerup, and promptly moved in. The place isn't much, but for the next two years it's home. 

PREPARE YOUR SPIRIT FOR . . .

RYAN QUEST 2
An Interactive Fiction by Maxwell Joslyn
Release 1 / Serial number 181205 / Inform 7 build 6M62 (I6/v6.33 lib 6/12N) SD

Apartment
Your apartment is a cheery little box. On the east wall is a round window. A woven rug adorns the floor in the middle of the room. Along the west wall are a fridge and some shelves. A bed lies in the northwest corner, and a stove lies in the northeast.

On the stove is a frying pan.

On the shelves is a loaf of bread.

You can also see an apartment door, a backpack (empty), a dwarf banana tree, a fridge (closed) and the bed (on which are bedsheets and a pair of Central European panties) here.

* * *

>gonear metro
Copenhagen Metro Station
This is the main metro station in Copenhagen. Its creator won the Best Dane of the Year Award.

Stairs lead southward and upward to the IIT Campus exit.

Christiana is northwest of here, but don't go there at night.

The Danes have built an efficient route running west, from here to the Aarenhus Cemetery.

A staircase leading downward is adorned with an arrow-shaped sign reading "THIS WAY FOR MONEY".

A small door stands in the southeast corner of the station near a fake tree.

You can see an arrow-shaped sign and the fake tree here.

>dirs
From here you can go northwest, south, southeast, west and up.

* * *

>l
Copenhagen Metro Station
This is the main metro station in Copenhagen. Its creator won the Best Dane of the Year Award.

Stairs lead southward and upward to the IIT Campus exit. Christiana is northwest of here: this much you know.

The Danes are very efficient: you can also take a direct route west from here to the Aarenhus Cemetery.

A small door stands in the southeast corner of the station near a fake tree.

You can see the fake tree here.

* * *

>dirs
From here you can go northwest, south, southeast, west and up.

>up
IIT Campus
The campus is pretty sleepy in the summer. A construction crew works below the bell tower, but the only student you see is Ana.

You can see Ana and a stone bench here.

>dirs
Ordinary exits are north and down.

>help
Good fortune awaits you if you use these keys:
look  -  l  -  Describes the room you're in and what you perceive there. If you specify a direct object (e.g. 'l/look toy'), you'll investigate something more closely and get a more detailed description.
take  -  take  -  Picks something up to take with you.
inventory  -  i  -  Checks the items you're carrying with you.
dirs  -  [none]  -  Lists the places you can go from this area.
wait  -  r  -  Waits for one turn. Useful for anything time-based.
In general, remember to look at everything for clues and take anything you desire. Good luck!

* * *

>gonear metro
Copenhagen Metro Station
This is the main metro station in Copenhagen. Its creator won the Best Dane of the Year Award.

Stairs lead southward and upward to the IIT Campus exit.

Christiana is northwest of here, but don't go there at night.

The Danes have built an efficient route running west, from here to the Aarenhus Cemetery.

A staircase leading downward is adorned with an arrow-shaped sign reading "THIS WAY FOR MONEY".

A small door stands in the southeast corner of the station near a fake tree.

You can see an arrow-shaped sign and the fake tree here.

>down
Socialist Money Commissary
The inside of the commissary is a bit cramped, but the lighting is gentle and there is air-conditioning. 

You can see a clerk, a one-krone note, a two-kroner note and a three-kroner note here.

>l clerk
She gives you the smile of a true believer.

* * *

>gonear metro
Copenhagen Metro Station
This is the main metro station in Copenhagen. Its creator won the Best Dane of the Year Award.

Stairs lead southward and upward to the IIT Campus exit.

Christiana is northwest of here, but don't go there at night.

The Danes have built an efficient route running west, from here to the Aarenhus Cemetery.

A staircase leading downward is adorned with an arrow-shaped sign reading "THIS WAY FOR MONEY".

A small door stands in the southeast corner of the station near a fake tree.

You can see an arrow-shaped sign and the fake tree here.

>enter socia
You can't see any such thing.

>enter socialist
You get into the Socialist Money Commissary.

>l
Copenhagen Metro Station (in the Socialist Money Commissary)
This is the main metro station in Copenhagen. Its creator won the Best Dane of the Year Award.

Stairs lead southward and upward to the IIT Campus exit. Christiana is northwest of here: this much you know.

The Danes are very efficient: you can also take a direct route west from here to the Aarenhus Cemetery.

A small door stands in the southeast corner of the station near a fake tree.

* * *

>gonear metro
Copenhagen Metro Station
This is the main metro station in Copenhagen. Its creator won the Best Dane of the Year Award.

Stairs lead southward and upward to the IIT Campus exit.

Christiana is northwest of here, but don't go there at night.

The Danes have built an efficient route running west, from here to the Aarenhus Cemetery.

A staircase leading downward is adorned with an arrow-shaped sign reading "THIS WAY FOR MONEY".

A small door stands in the southeast corner of the station near a fake tree.

You can see an arrow-shaped sign and the fake tree here.

>enter socialist
That's not something you can enter.

>enter money commissary
That's not something you can enter.

>enter commissary
That's not something you can enter.

>l
Copenhagen Metro Station
This is the main metro station in Copenhagen. Its creator won the Best Dane of the Year Award.

Stairs lead southward and upward to the IIT Campus exit. Christiana is northwest of here: this much you know.

The Danes are very efficient: you can also take a direct route west from here to the Aarenhus Cemetery.

A small door stands in the southeast corner of the station near a fake tree.

You can see a Socialist Money Commissary (empty) here.

>enter tree
You walk up to the fake tree. Your instincts propel you onward, and you walk into the tree.

You're inside the tree, Ryan.

(first opening the fake tree)

Belly of the Tree
It's gloomy in here.

* * *

>enter socialist
That's not something you can enter.

>l
Copenhagen Metro Station (in the Socialist Money Commissary)
This is the main metro station in Copenhagen. Its creator won the Best Dane of the Year Award.

Stairs lead southward and upward to the IIT Campus exit. Christiana is northwest of here: this much you know.

The Danes are very efficient: you can also take a direct route west from here to the Aarenhus Cemetery.

A small door stands in the southeast corner of the station near a fake tree.

* * *

>gonear monk
Island of Technique
This little island is no tropical paradise. It's more like someone carved a chunk off of Scotland and dropped it at the edge of the bay. Foggy, muddy, and riddled with trees.

You can see a monk here.

>ask monk for herrin
You can't see any such thing.

>ask monk for herring
You can't see any such thing.

>ask monk for robe
The monk has better things to do.

>ask monk for box
The monk has better things to do.

>l
Island of Technique
This little island is no tropical paradise. It's more like someone carved a chunk off of Scotland and dropped it at the edge of the bay. Foggy, muddy, and riddled with trees.

You can see a monk here.

>l monk
He stands solemnly, with his hands folded in the sleeves of his robe. In one hand he carries a small wooden box.

>tak box
That's not a verb I recognize.

>take box
That seems to belong to the monk.

>ask monk for box
The monk has better things to do.

* * *

>gonear monk
Island of Technique
This little island is no tropical paradise. It's more like someone carved a chunk off of Scotland and dropped it at the edge of the bay. Foggy, muddy, and riddled with trees.

You can see a monk here.

>ask monk for money
The monk waves a hand. "I do not have 5 kroner to give you, traveler."

(the monk first taking 5 kroner)
The monk has better things to do.

* * *

>gonear monk
Island of Technique
This little island is no tropical paradise. It's more like someone carved a chunk off of Scotland and dropped it at the edge of the bay. Foggy, muddy, and riddled with trees.

You can see a monk here.

>ask monk for potato
You can't see any such thing.

>ask monk for herring
You can't see any such thing.

* * *

>gonear monk
Island of Technique
This little island is no tropical paradise. It's more like someone carved a chunk off of Scotland and dropped it at the edge of the bay. Foggy, muddy, and riddled with trees.

You can see a monk here.

>take box
The monk holds the wooden box out of your reach. Do you ask him for it?

>y
The monk gestures at the top right corner of the screen. "Your score is too low for you to receive my blessing, traveler!" he says.

>take box
The monk holds the wooden box out of your reach. Do you ask him for it?

* * *

>take box
The monk holds the wooden box out of your reach. Do you ask him for it?

* * *

>gonear monk
Island of Technique
This little island is no tropical paradise. It's more like someone carved a chunk off of Scotland and dropped it at the edge of the bay. Foggy, muddy, and riddled with trees.

You can see a monk here.

>x monk
He stands solemnly, with his hands folded in the sleeves of his robe. In one hand he carries a small wooden box.

>ask monk for box
The monk gestures at the top right corner of the screen. "Your score is too low for you to receive my blessing, traveler!" he says.

* * *

>x monk
He stands solemnly, with his hands folded in the sleeves of his robe. In one hand he carries a small wooden box.

>l
Island of Technique
This little island is no tropical paradise. It's more like someone carved a chunk off of Scotland and dropped it at the edge of the bay. Foggy, muddy, and riddled with trees.

You can see a monk here.

>l monk
He stands solemnly, with his hands folded in his sleeves.

>purloin robe
[Purloined.]

>x monk
He stands solemnly, with his hands at his sides.

* * *

>gonear one-kroner note
Commissary Counter
You can see a clerk, an one-kroner note, a two-kroner note and a three-kroner note here.

>l
Commissary Counter
You can see a clerk, an one-kroner note, a two-kroner note and a three-kroner note here.

>take one-kroner note
Ignorant American! Under Socialism, everyone has a job to do - and the clerk's job is to do that for you.

The clerk picks up the one-kroner note.

The clerk gives the one-kroner note to you.

>i
You are carrying:
  an one-kroner note
  a wallet
    5 kroner
    1 Uncle Sam

>i
You are carrying:
  an one-kroner note
  a wallet
    5 kroner
    1 Uncle Sam

>l
Commissary Counter
You can see a clerk, a two-kroner note and a three-kroner note here.

>l
Commissary Counter
You can see a clerk, a two-kroner note and a three-kroner note here.

I beg your pardon?

>i
You are carrying:
  an one-kroner note
  a wallet
    5 kroner
    1 Uncle Sam

>z
Time passes.

>i
You are carrying:
  an one-kroner note
  a wallet
    5 kroner
    1 Uncle Sam

* * *

>gonear pusher
Christiana Main Street
This street is lined with drug pushers, filled with tourists, dotted with hippies, and sprinkled with musicians.

You can see a pusher and a pushcart (on which is a marijuana joint) here.

The pusher eyes your wallet.

>touch pusher
Mind your manners, American!

The pusher eyes your wallet.

>press pusher
Mind your manners, American!

The pusher eyes your wallet.

>gonear anna
There seems to be no such object anywhere in the model world.

>gonear naa
There seems to be no such object anywhere in the model world.

>gonear ana
IIT Campus
The campus is pretty sleepy in the summer. A construction crew works below the bell tower, but the only student you see is Ana.

You can see Ana and a stone bench here.

>touch ana
She slaps your hand away.

>push ana
Ana might not like that.

>press ana
Mind your manners, American!

* * *

>gonear red flower
Aarenhus Cemetery
Dark paths run here and there among the marble tombs. Some trees provide relaxing shade, and white flowers bloom here and there.

You can see a red flower, a white flower, a blue flower and a yellow flower here.

>i
You are carrying:
  a wallet
    5 kroner
    1 Uncle Sam

>relax
[You have revealed a secret elsewhere.]
You take a deep breath and let it out slowly. Tension disappears from your body.

>s
You can't go that way.

>w
You can't go that way.

>e
Copenhagen Metro Station
This is the main metro station in Copenhagen. Its creator won the Best Dane of the Year Award.

Stairs lead southward and upward to the IIT Campus exit. Christiana is northwest of here: this much you know.

The Danes are very efficient: you can also take a direct route west from here to the Aarenhus Cemetery.

A small door stands in the southeast corner of the station near a fake tree.

You can see the fake tree (closed) here.

>open tree
You open the fake tree.

>enter tree
That's not something you can enter.

>l tree
The fake tree is empty.

>x tree
The fake tree is empty.

>w
Aarenhus Cemetery
Dark paths run here and there among the marble tombs. Some trees provide relaxing shade, and white flowers bloom here and there.

You can see a red flower, a white flower, a blue flower and a yellow flower here.

>relax
You take a deep breath and let it out slowly. Tension disappears from your body.

>take all
red flower: Taken.
white flower: Taken.
blue flower: You're carrying too many things already.
yellow flower: You're carrying too many things already.

* * *

>drop all
white flower: Dropped.
red flower: Dropped.
wallet: Dropped.

>purloin backpack
[Purloined.]

>take all
wallet: Taken.
red flower: Taken.
white flower: (putting the wallet into the backpack to make room)
Taken.
blue flower: (putting the red flower into the backpack to make room)
Taken.
yellow flower: (putting the white flower into the backpack to make room)
Taken.
5 kroner: No need to do anything with that until you want to buy something.
1 Uncle Sam: (putting the blue flower into the backpack to make room)
Taken.

>w
You can't go that way.

I beg your pardon?

>e
Copenhagen Metro Station
This is the main metro station in Copenhagen. Its creator won the Best Dane of the Year Award.

Stairs lead southward and upward to the IIT Campus exit. Christiana is northwest of here: this much you know.

The Danes are very efficient: you can also take a direct route west from here to the Aarenhus Cemetery.

A small door stands in the southeast corner of the station near a fake tree.

You can see a C-Train (in which is a wrap-around sofa) and the fake tree (empty) here.

>n
You can't go that way.

>s
IIT Campus
The campus is pretty sleepy in the summer. A construction crew works below the bell tower, but the only student you see is Ana.

You can see Ana and a stone bench here.

>give flower ana
You can only do that to something animate.

>give blue flower to ana
(first taking the blue flower)
(putting the yellow flower into the backpack to make room)
Ana sighs and kisses your cheek. She strolls over to the bench, and sits down to gaze at the flower.

[Your score has just gone up by one point.]

>give flower to ana
Which do you mean, the yellow flower, the white flower, the red flower or the blue flower?

>red
(first taking the red flower)
Ana giggles.

>give white to ana
(first taking the white flower)
Ana grins.

>give yellow to ana
(first taking the yellow flower)
Ana blushes.

>kiss ana
You plant your parted lips on her cheek, and she squeals in delight.

>kiss ana
You plant your quivering lips on her forehead, and she wiggles in delight.

>kiss ana
You plant your searching lips on her nose, and she squeals in delight.

>kiss ana
You plant your searching lips on her cheek, and she squeals in delight.

>kiss ana
You plant your searching lips on her forehead, and she wiggles in delight.

>kiss ana
You plant your searching lips on her nose, and she squeals in delight.

* * *

>kiss ana
You plant your searching lips on her cheek, and she squeals in delight.

>kiss ana
You plant your parted lips on her nose, and she wiggles in delight.

>kiss ana
You plant your soft lips on her forehead, and she squeals in delight.

>kiss ana
You plant your parted lips on her cheek, and she wiggles in delight.

>kiss ana
You plant your searching lips on her nose, and she wiggles in delight.

>kiss ana
You plant your soft lips on her cheek, and she wiggles in delight.

>n
Copenhagen Metro Station
This is the main metro station in Copenhagen. Its creator won the Best Dane of the Year Award.

Stairs lead southward and upward to the IIT Campus exit. Christiana is northwest of here: this much you know.

The Danes are very efficient: you can also take a direct route west from here to the Aarenhus Cemetery.

A small door stands in the southeast corner of the station near a fake tree.

You can see a C-Train (in which is a wrap-around sofa) and the fake tree (empty) here.

>nw
Christiana Main Street
This street is lined with drug pushers, filled with tourists, dotted with hippies, and sprinkled with musicians.

You can see a pusher and a pushcart (on which is a marijuana joint) here.

The pusher eyes your backpack.

>buy joint
You pay 2 kroner for the marijuana joint, leaving yourself with 3 kroner.

The pusher eyes your backpack.

>l pusher
His eyes are freaky, but your friends say he's honest.

The pusher eyes your 1 Uncle Sam.

>x pusher
His eyes are freaky, but your friends say he's honest.

The pusher eyes your 1 Uncle Sam.

>smoke joint
The pusher eyes your backpack.

[Your score has just gone up by one point.]

>i
You are carrying:
  a marijuana joint
  1 Uncle Sam
  a backpack (open)
    a wallet
      3 kroner

The pusher eyes your 1 Uncle Sam.

>smoke joint
You hit it and don't quit it. Your War-on-Drugs work ethic erases that joint from existence.

Now you're baked.

The pusher eyes your backpack.

>restart
Are you sure you want to restart?

* * *

>gonear joint
Christiana Main Street
This street is lined with drug pushers, filled with tourists, dotted with hippies, and sprinkled with musicians.

You can see a pusher and a pushcart (on which is a marijuana joint) here.

The pusher eyes your wallet.

>tkae joint
That's not a verb I recognize.

>buy joint
You pay 2 kroner for the marijuana joint, leaving yourself with 3 kroner.

The pusher eyes your marijuana joint.

>smoke joint
The pusher eyes your marijuana joint.

[Your score has just gone up by one point.]

* * *

>gonear sig
There seems to be no such object anywhere in the model world.

>gonear sign
Which do you mean, the wall sign or the small sign?

>wall sign
Train Platform
The open-air train platform has a line that runs to Copenhagen every 10 minutes. There are no tickets: it is free to ride.

You can see a wall sign and a paper kroner here.

The C-Train arrives.

>x sign
It reads, 'PLEASE WAIT FOR TRAIN'

I beg your pardon?

>x
(the wallet)
In the wallet are 5 kroner and 1 Uncle Sam.

>i
You are carrying:
  a wallet
    5 kroner
    1 Uncle Sam

>purloin steak
[Purloined.]

>dance
That's not a verb I recognize.

>eat sign
Foolish American, have you truly mistaken the wall sign for food?

* * *

>gonear sign
Which do you mean, the wall sign or the small sign?

>wall
Train Platform
The open-air train platform has a line that runs to Copenhagen every 10 minutes. There are no tickets: it is free to ride.

You can see a wall sign and a paper kroner here.

The C-Train arrives.

>gonear small
(the small sign)
Copenhagen Metro Station
This is the main metro station in Copenhagen. Its creator won the Best Dane of the Year Award.

Stairs lead southward and upward to the IIT Campus exit. Christiana is northwest of here: this much you know.

The Danes are very efficient: you can also take a direct route west from here to the Aarenhus Cemetery.

A small door stands in the southeast corner of the station near a fake tree.

You can see the fake tree here.

>x sign
The hand-lettered sign reads, "My friend, you've gotten 0 points so far."

>take sign
That seems to be a part of the small door.

>go thru door
You can't see any such thing.

>go through
(the wallet)
That's not something you can enter.

>go through door
(first opening the small door)

The Path
This odd little path runs out of the metro station and terminates at a promontory overlooking the bay. The ground is grassy, but the only larger vegetation is a gnarled bush.

Out in the bay is a small island.

>enter door
Copenhagen Metro Station
This is the main metro station in Copenhagen. Its creator won the Best Dane of the Year Award.

Stairs lead southward and upward to the IIT Campus exit. Christiana is northwest of here: this much you know.

The Danes are very efficient: you can also take a direct route west from here to the Aarenhus Cemetery.

A small door stands in the southeast corner of the station near a fake tree.

You can see the fake tree here.

The C-Train arrives.

>enter door
The Path
This odd little path runs out of the metro station and terminates at a promontory overlooking the bay. The ground is grassy, but the only larger vegetation is a gnarled bush.

Out in the bay is a small island.

>x fake
You can't see any such thing.

>x tree
You can't see any such thing.

>enter
You must supply a noun.

>inside
You can't go that way.

>enter door
Copenhagen Metro Station
This is the main metro station in Copenhagen. Its creator won the Best Dane of the Year Award.

Stairs lead southward and upward to the IIT Campus exit. Christiana is northwest of here: this much you know.

The Danes are very efficient: you can also take a direct route west from here to the Aarenhus Cemetery.

A small door stands in the southeast corner of the station near a fake tree.

You can see a C-Train (in which is a wrap-around sofa) and the fake tree here.

>x tree
A huge plastic palm tree, fifteen feet tall and twenty feet around. It 'grows' from an inch-thick disc of marble which is set into the floor of the station, disrupting the pattern of tiles around it.

The C-Train departs without you.

>gonear sofa
Train Tunnel
This underwater transit tunnel represents a feat of engineering. Its creator won the Most Illustrious Dane medal.

You can see a C-Train (in which is a wrap-around sofa) here.

>l
Train Tunnel
This underwater transit tunnel represents a feat of engineering. Its creator won the Most Illustrious Dane medal.

>i
You are carrying:
  a wallet
    5 kroner
    1 Uncle Sam

>l
Train Tunnel
This underwater transit tunnel represents a feat of engineering. Its creator won the Most Illustrious Dane medal.

>x
(the wallet)
You picked this bad boy up in Italy. It's a genuine Silvatorio Mossaganezza.

In the wallet are 5 kroner and 1 Uncle Sam.

* * *

>i
You are carrying:
  a wallet
    5 kroner
    1 Uncle Sam

>w
You can't go that way.

>wait
Time passes.

>w
You can't go that way.

>r
Time passes.

>gonear sign
Which do you mean, the wall sign or the small sign?

>wall
Train Platform
The open-air train platform has a line that runs to Copenhagen every 10 minutes. There are no tickets: it is free to ride.

You can see a wall sign and a paper kroner here.

>l
Train Platform
The open-air train platform has a line that runs to Copenhagen every 10 minutes. There are no tickets: it is free to ride.

You can see a wall sign and a paper kroner here.

>l
Train Platform
The open-air train platform has a line that runs to Copenhagen every 10 minutes. There are no tickets: it is free to ride.

You can see a wall sign and a paper kroner here.

I beg your pardon?

* * *

>r
Time passes.

>enter
You get into the C-Train.

In the C-Train you can see a wrap-around sofa.

* * *

>gonear sofa
Train Tunnel
This underwater transit tunnel represents a feat of engineering. Its creator won the Most Illustrious Dane medal.

You can see a C-Train (in which is a wrap-around sofa) here.

* * *

>l
Train Tunnel
This underwater transit tunnel represents a feat of engineering. Its creator won the Most Illustrious Dane medal.

>enter
You must supply a noun.

>enter train
You can't see any such thing.

>enter c-train
You can't see any such thing.

>l
Train Tunnel
This underwater transit tunnel represents a feat of engineering. Its creator won the Most Illustrious Dane medal.

>l
Train Tunnel
This underwater transit tunnel represents a feat of engineering. Its creator won the Most Illustrious Dane medal.

>l
Train Tunnel
This underwater transit tunnel represents a feat of engineering. Its creator won the Most Illustrious Dane medal.

You can see a C-Train (in which is a wrap-around sofa) here.

>l
Train Tunnel
This underwater transit tunnel represents a feat of engineering. Its creator won the Most Illustrious Dane medal.

>enter train
You can't see any such thing.

>i
You are carrying:
  a wallet
    5 kroner
    1 Uncle Sam

>enter c-tran
You can't see any such thing.

>enter c-train
You can't see any such thing.

>i
You are carrying:
  a wallet
    5 kroner
    1 Uncle Sam

* * *

>l
Train Tunnel
This underwater transit tunnel represents a feat of engineering. Its creator won the Most Illustrious Dane medal.

>w
You can't go that way.

>e
You can't go that way.

>gonear sfa
There seems to be no such object anywhere in the model world.

>gonear sofa
Train Platform
The open-air train platform has a line that runs to Copenhagen every 10 minutes. There are no tickets: it is free to ride.

You can see a C-Train (in which is a wrap-around sofa), a wall sign and a paper kroner here.

>enter train
You get into the C-Train.

In the C-Train you can see a wrap-around sofa.

>l
Train Platform (in the C-Train)
The open-air train platform has a line that runs to Copenhagen every 10 minutes. There are no tickets: it is free to ride.

You can see a wall sign and a paper kroner here.

In the C-Train you can see a wrap-around sofa.

>l
Train Platform (in the C-Train)
The open-air train platform has a line that runs to Copenhagen every 10 minutes. There are no tickets: it is free to ride.

You can see a wall sign and a paper kroner here.

In the C-Train you can see a wrap-around sofa.

>l
Train Platform (in the C-Train)
The open-air train platform has a line that runs to Copenhagen every 10 minutes. There are no tickets: it is free to ride.

You can see a wall sign and a paper kroner here.

In the C-Train you can see a wrap-around sofa.

The C-Train departs, taking you into a tunnel.

>l
Train Tunnel (in the C-Train)
This underwater transit tunnel represents a feat of engineering. Its creator won the Most Illustrious Dane medal.

In the C-Train you can see a wrap-around sofa.

You arrive in Copenhagen.

>l
Copenhagen Metro Station (in the C-Train)
This is the main metro station in Copenhagen. Its creator won the Best Dane of the Year Award.

Stairs lead southward and upward to the IIT Campus exit. Christiana is northwest of here: this much you know.

The Danes are very efficient: you can also take a direct route west from here to the Aarenhus Cemetery.

A small door stands in the southeast corner of the station near a fake tree.

You can see the fake tree here.

In the C-Train you can see a wrap-around sofa.

>l sofa
Made of plush leather for discerning Danish derrieres.

>exit
Copenhagen Metro Station
This is the main metro station in Copenhagen. Its creator won the Best Dane of the Year Award.

Stairs lead southward and upward to the IIT Campus exit. Christiana is northwest of here: this much you know.

The Danes are very efficient: you can also take a direct route west from here to the Aarenhus Cemetery.

A small door stands in the southeast corner of the station near a fake tree.

You can see a C-Train (in which is a wrap-around sofa) and the fake tree here.

>i
You are carrying:
  a wallet
    5 kroner
    1 Uncle Sam

>purloin all
[Purloined.]
[Purloined.]
[Purloined.]
[Purloined.]
[Purloined.]
[Purloined.]
[Can't move Copenhagen Metro Station: it would contain itself.]
[Purloined.]
[Purloined.]
[Purloined.]
[Purloined.]
[Purloined.]
[Purloined.]
[Purloined.]
[Purloined.]
[Purloined.]
[Purloined.]
[Purloined.]
[Purloined.]
[Purloined.]
[Purloined.]
[Purloined.]
[Purloined.]
[Purloined.]
[Purloined.]
[Purloined.]
[Purloined.]
[Purloined.]
[Purloined.]
[Purloined.]
[Purloined.]
[Can't move handle: it's part of the fridge.]
[Can't move pocket: it's part of the long coat.]
[Purloined.]
[Purloined.]
[Purloined.]
[Purloined.]
[Purloined.]
[Purloined.]
[Purloined.]
[Purloined.]
[Purloined.]
[Purloined.]
[Purloined.]
[Purloined.]
[Purloined.]
[Purloined.]
[Purloined.]
[Purloined.]
[Purloined.]
[Purloined.]
[Purloined.]
[Purloined.]
[Purloined.]
[Purloined.]
[Can't move small sign: it's part of the small door.]
[Purloined.]
[Can't move button: it's part of the stone bench.]
[Purloined.]
[Purloined.]
[Purloined.]
[Purloined.]
[Purloined.]
[Purloined.]
[Purloined.]
[Purloined.]
[Purloined.]
[Purloined.]
[Purloined.]
[Purloined.]
[Purloined.]
[Purloined.]
[Purloined.]
[Purloined.]
[Purloined.]
[Purloined.]
[Purloined.]
[Purloined.]
[Purloined.]
[Purloined.]
[Purloined.]
[Purloined.]

>i
You are carrying:
  the outside
  the inside
  the down
  the up
  the west
  the east
  the southwest
  the southeast
  the south
  the northwest
  the northeast
  the north
  a gnarled bush
  some trees
  some marble tombs
  a rope
  a rowboat
  some row houses
  some shelves
  a round window
  a stove
  a rug
  a monk
  an Island of Technique (providing light)
  a Belly of the Tree (providing light)
  The Path (providing light)
  a yellow flower
  a blue flower
  a white flower
  a red flower
  Aarenhus Cemetery (providing light)
  a marijuana joint
  a pushcart
  a pusher
  Christiana Main Street (providing light)
  a stone bench
  Ana
  IIT Campus (providing light)
  Copenhagen
  Train Tunnel (providing light)
  a paper kroner
  a wall sign
  a Train Platform (providing light)
  a wretched bird
  the herring crate
  a Dock (providing light)
  a fistful of herring
  a mound of herring
  a pile of herring
  a wheelbarrow
  a street vendor
  Hellerup Strandvejen (providing light)
  an apartment door
  a pair of Central European panties
  bedsheets
  the bed
  some Dankdrinke
  a glass bottle (closed)
  a steak
  a piece of cheese
  a fridge (closed)
  a dwarf banana tree
  a loaf of bread
  a frying pan
  a backpack (open but empty)
  an Apartment (providing light)
  Hellerup
  the friendly bird
  the bald eagle
  Limbo (providing light)
  a small door
  a wrap-around sofa
  1 Uncle Sam
  5 kroner
  the fake tree
  a C-Train
  a wallet

The pusher eyes your monk.

The C-Train departs without you.

I beg your pardon?

>give island to pusher
The pusher eyes your gnarled bush.

>give pusher to sam
You can't see any such thing.

>take sam
You already have that.

The vendor winks at you.

The pusher eyes your trees.

>eat sam
Foolish American, have you truly mistaken 1 Uncle Sam for food?

The pusher eyes your steak.

>kick bird
That's not a verb I recognize.

>eat bird
Who do you mean, the wretched bird or the friendly bird?

>wretched
Foolish American, have you truly mistaken the wretched bird for food?

The pusher eyes your piece of cheese.

>eat cheese
You eat the piece of cheese. Not bad.

The pusher eyes your rowboat.

>eat all
You can't use multiple objects with that verb.

>eat
What do you want to eat?

>food
You can't see any such thing.

>l
Copenhagen Metro Station
This is the main metro station in Copenhagen. Its creator won the Best Dane of the Year Award.

Stairs lead southward and upward to the IIT Campus exit. Christiana is northwest of here: this much you know.

The Danes are very efficient: you can also take a direct route west from here to the Aarenhus Cemetery.

A small door stands in the southeast corner of the station near a fake tree.

The vendor grins cheerfully.

The pusher eyes your red flower.

>i
You are carrying:
  the outside
  the inside
  the down
  the up
  the west
  the east
  the southwest
  the southeast
  the south
  the northwest
  the northeast
  the north
  a gnarled bush
  some trees
  some marble tombs
  a rope
  a rowboat
  some row houses
  some shelves
  a round window
  a stove
  a rug
  a monk
  an Island of Technique (providing light)
  a Belly of the Tree (providing light)
  The Path (providing light)
  a yellow flower
  a blue flower
  a white flower
  a red flower
  Aarenhus Cemetery (providing light)
  a marijuana joint
  a pushcart
  a pusher
  Christiana Main Street (providing light)
  a stone bench
  Ana
  IIT Campus (providing light)
  Copenhagen
  Train Tunnel (providing light)
  a paper kroner
  a wall sign
  a Train Platform (providing light)
  a wretched bird
  the herring crate
  a Dock (providing light)
  a fistful of herring
  a mound of herring
  a pile of herring
  a wheelbarrow
  a street vendor
  Hellerup Strandvejen (providing light)
  an apartment door
  a pair of Central European panties
  bedsheets
  the bed
  some Dankdrinke
  a glass bottle (closed)
  a steak
  a fridge (closed)
  a dwarf banana tree
  a loaf of bread
  a frying pan
  a backpack (open but empty)
  an Apartment (providing light)
  Hellerup
  the friendly bird
  the bald eagle
  Limbo (providing light)
  a small door
  a wrap-around sofa
  1 Uncle Sam
  5 kroner
  the fake tree
  a wallet

The pusher eyes your friendly bird.

The C-Train arrives.

I beg your pardon?

>l
Copenhagen Metro Station
This is the main metro station in Copenhagen. Its creator won the Best Dane of the Year Award.

Stairs lead southward and upward to the IIT Campus exit. Christiana is northwest of here: this much you know.

The Danes are very efficient: you can also take a direct route west from here to the Aarenhus Cemetery.

A small door stands in the southeast corner of the station near a fake tree.

You can see a C-Train (empty) here.

The pusher eyes your fistful of herring.

I beg your pardon?

>w
That's not a verb I recognize.

>g
That's not a verb I recognize.

>g
That's not a verb I recognize.

I beg your pardon?

>wr
That's not a verb I recognize.

>r
Time passes.

The vendor taps his foot.

The pusher eyes your street vendor.

>g
Time passes.

The vendor grins cheerfully.

The pusher eyes your Dankdrinke.

>g
Time passes.

The pusher eyes your pile of herring.

>g
Time passes.

The vendor taps his foot.

The pusher eyes your stove.

The C-Train departs without you.

>g
Time passes.

The pusher eyes your white flower.

>g
Time passes.

The pusher eyes your pusher.

>g
Time passes.

The vendor winks at you.

The pusher eyes your paper kroner.

I beg your pardon?

>g
Time passes.

The vendor taps his foot.

The pusher eyes your marble tombs.

>g
Time passes.

The pusher eyes your bedsheets.

>g
Time passes.

The pusher eyes your trees.

>g
Time passes.

The vendor grins cheerfully.

The pusher eyes your round window.

The C-Train arrives.

>g
Time passes.

The vendor taps his foot.

The pusher eyes your trees.

>g
Time passes.

The pusher eyes your pushcart.

>g
Time passes.

The pusher eyes your pair of Central European panties.

>g
Time passes.

The vendor winks at you.

The pusher eyes your Ana.

>g
Time passes.

The pusher eyes your loaf of bread.

The C-Train departs without you.

>g
Time passes.

The pusher eyes your wheelbarrow.

>g
Time passes.

The vendor grins cheerfully.

The pusher eyes your monk.

>g
Time passes.

The pusher eyes your street vendor.

>g
Time passes.

The pusher eyes your pile of herring.

>g
Time passes.

The pusher eyes your loaf of bread.

>g
Time passes.

The pusher eyes your pushcart.

>g
Time passes.

The pusher eyes your gnarled bush.

The C-Train arrives.

>g
Time passes.

The pusher eyes your apartment door.

>take all
There are none at all available!

>drop all
Island of Technique: 
*** Run-time problem P54: Tried to move the Island of Technique (not a thing) to Copenhagen Metro Station, but only things can move around.

Dropped.
Belly of the Tree: Dropped.
The Path: Dropped.
yellow flower: Dropped.
blue flower: Dropped.
white flower: Dropped.
red flower: Dropped.
Aarenhus Cemetery: Dropped.
marijuana joint: Dropped.
pushcart: Dropped.
Christiana Main Street: Dropped.
stone bench: Dropped.
IIT Campus: Dropped.
Copenhagen: Dropped.
Train Tunnel: Dropped.
paper kroner: Dropped.
wall sign: Dropped.
Train Platform: Dropped.
herring crate: Dropped.
Dock: Dropped.
fistful of herring: Dropped.
mound of herring: Dropped.
pile of herring: Dropped.
wheelbarrow: Dropped.
Hellerup Strandvejen: Dropped.
apartment door: Dropped.
pair of Central European panties: Dropped.
bedsheets: Dropped.
bed: Dropped.
Dankdrinke: Dropped.
glass bottle: Dropped.
steak: Dropped.
fridge: Dropped.
dwarf banana tree: Dropped.
loaf of bread: Dropped.
frying pan: Dropped.
backpack: Dropped.
Apartment: Dropped.
Hellerup: Dropped.
Limbo: Dropped.
wrap-around sofa: Dropped.
1 Uncle Sam: Dropped.
5 kroner: Dropped.
fake tree: Dropped.
wallet: Dropped.
outside: You must name something more substantial.
inside: You must name something more substantial.
down: You must name something more substantial.
up: You must name something more substantial.
west: You must name something more substantial.
east: You must name something more substantial.
southwest: You must name something more substantial.
southeast: You must name something more substantial.
south: You must name something more substantial.
northwest: You must name something more substantial.
northeast: You must name something more substantial.
north: You must name something more substantial.
gnarled bush: Dropped.
trees: Dropped.
marble tombs: Dropped.
rope: Dropped.
rowboat: Dropped.
row houses: Dropped.
shelves: Dropped.
round window: Dropped.
stove: Dropped.
rug: Dropped.
small door: Dropped.

The pusher eyes your street vendor.

* * *

>gonear tombs
Aarenhus Cemetery
Dark paths run here and there among the marble tombs. Some trees provide relaxing shade, and white flowers bloom here and there.

You can see a few flowers here.

>i
You are carrying:
  a wallet
    5 kroner
    1 Uncle Sam

>x tombs
Your attention rests on a tomb of pale white marble with gold streaks.

>x tombs
Your attention rests on a tomb of blue-gray marble with pinkish streaks.

>x tomb
You can't see any such thing.

>take flower
You pluck a flower from where it grows.

* * *

>gonear train
Which do you mean, the Train Platform, Train Tunnel or the C-Train?

>c-train
Train Tunnel
This underwater transit tunnel represents a feat of engineering. Its creator won the Most Illustrious Dane medal.

You can see a C-Train (in which is a wrap-around sofa) here.

>take train
You can hardly pick up a train!

>x
(the wallet)
In the wallet are 5 kroner and 1 Uncle Sam.

* * *

>i
You are carrying:
  a wallet
    5 kroner
    1 Uncle Sam

>l
Train Tunnel
This underwater transit tunnel represents a feat of engineering. Its creator won the Most Illustrious Dane medal.

You can see a C-Train (in which is a wrap-around sofa) here.

I beg your pardon?

>e
You can't go that way.

>enter train
You can't see any such thing.

* * *

>enter c-train
You can't see any such thing.

>gonear train
(Train Tunnel)
Train Tunnel
This underwater transit tunnel represents a feat of engineering. Its creator won the Most Illustrious Dane medal.

>gonear c-train
Train Platform
The open-air train platform has a line that runs to Copenhagen every 10 minutes. There are no tickets: it is free to ride.

You can see a C-Train (in which is a wrap-around sofa) and a paper kroner here.

>enter c-train
You get into the C-Train.

In the C-Train you can see a wrap-around sofa.

>r
Time passes.

The C-Train departs, taking you into a tunnel.

* * *

>r
Time passes.

You arrive in Copenhagen.

>exit c-train
I only understood you as far as wanting to exit.

>exit
Copenhagen Metro Station
This is the main metro station in Copenhagen. Its creator won the Best Dane of the Year Award.

Stairs lead southward and upward to the IIT Campus exit. Christiana is northwest of here: this much you know.

The Danes are very efficient: you can also take a direct route west from here to the Aarenhus Cemetery.

A small door stands in the southeast corner of the station near a fake tree.

You can see a C-Train (in which is a wrap-around sofa) and the fake tree (closed) here.

* * *

>gonear tree
(the dwarf banana tree)
Apartment
Your apartment is a cheery little cube. On the east wall is a round window. A woven rug adorns the floor in the middle of the room. Along the west wall are a fridge and some shelves. A bed lies in the northwest corner, and a stove lies in the northeast.

On the stove is a frying pan.

On the shelves is a loaf of bread.

You can also see an apartment door, a backpack (empty), a dwarf banana tree, a fridge (closed) and the bed (on which are bedsheets and a pair of Central European panties) here.

>gonear fake tree
Copenhagen Metro Station
This is the main metro station in Copenhagen. Its creator won the Best Dane of the Year Award.

Stairs lead southward and upward to the IIT Campus exit. Christiana is northwest of here: this much you know.

The Danes are very efficient: you can also take a direct route west from here to the Aarenhus Cemetery.

A small door stands in the southeast corner of the station near a fake tree.

>purloin joint
[Purloined.]

>smoke
What do you want to smoke?

>smoke it
You hit it and don't quit it. Your War-on-Drugs work ethic erases that joint from existence.

Now you're baked.

>enter tree
You walk up to the fake tree. Your instincts propel you onward, and you walk into the tree.

You're inside the tree, Ryan.

Darkness
It is pitch dark, and you can't see a thing.

I beg your pardon?

>l
Darkness
It is pitch dark, and you can't see a thing.

>exit
You walk up to the fake tree. Your instincts propel you onward, and you walk into the tree.

You're inside the tree, Ryan.

Copenhagen Metro Station
This is the main metro station in Copenhagen. Its creator won the Best Dane of the Year Award.

Stairs lead southward and upward to the IIT Campus exit. Christiana is northwest of here: this much you know.

The Danes are very efficient: you can also take a direct route west from here to the Aarenhus Cemetery.

A small door stands in the southeast corner of the station near a fake tree.

* * *

>gonear welder
There seems to be no such object anywhere in the model world.

I beg your pardon?

>l welder
You don't want to get in the way of their work.

>x welder
You don't want to get in the way of their work.

* * *

>gonear welder
There seems to be no such object anywhere in the model world.

>l welder
You don't want to get in the way of their work.

* * *

>x welder
You don't want to get in the way of their work.

>welder
That's not a verb I recognize.

>eat welder
Foolish American, have you truly mistaken the welder for food?

* * *

>gonear welder
There seems to be no such object anywhere in the model world.

>listen
You hear nothing unexpected.

>gonear pipefitter
IIT Campus
The campus is pretty sleepy in the summer. A construction crew works below the bell tower, but the only student you see is Ana.

You can see Ana, a stone bench, a pipefitter and a carpenter here.

>listen
The workers are sawing a board.

>liste
That's not a verb I recognize.

>listen
The workers are hammering a plank.

>listen
The workers are joking with each other.

>lisen
That's not a verb I recognize.

>listen
The workers are hammering a board.

>listen
The workers are joking with each other.

>listen
The workers are sawing a plank.

>listen
The workers are hammering a board.

* * *

>listen
The workers are sawing a plank.

>listen
The workers are joking with each other.

* * *

>gonear welder
There seems to be no such object anywhere in the model world.

>purloin joint
[Purloined.]

>x carpenter
You don't want to get in the way of their work.

>l
IIT Campus
The campus is pretty sleepy in the summer. A construction crew works below the bell tower, but the only student you see is Ana.

You can see Ana, a stone bench and the welder and the carpenter here.

>listen
The workers are sawing board .

>listen
The workers are hammering plank .

>listen
The workers are joking with each other.

>listen
The workers are hammering board .

>listen
The workers are joking with each other.

* * *

>gonear welder
There seems to be no such object anywhere in the model world.

>touch welder
You don't want to get in the way of their work.

>l welder
Short and squat.

>x carpenter
Tall and thin.

>l carpenter
Tall and thin.

>touch carpenter
The carpenter might not like that.

* * *

>gonear wlder
There seems to be no such object anywhere in the model world.

>gonear welder
IIT Campus
The campus is pretty sleepy in the summer. A construction crew works below the bell tower, but the only student you see is Ana.

You can see Ana, a stone bench and the welder and the carpenter here.

>i
You are carrying:
  a wallet
    5 kroner
    1 Uncle Sam

>l welder
You don't want to get in the way of their work.

* * *

>gonear wretched
Dock
This is a shabby little dock used for the fishing trade. At the end of the dock, a little rowboat, moored with a rope, bobs up and down. In the rowboat is a large crate, atop which sits a bird.

>isten
That's not a verb I recognize.

>listen
You hear the gentle wind that stirs the tides.

>l window
You can't see any such thing.

>x windw
You can't see any such thing.

>gonear window
Apartment
Your apartment is a cheery little box. On the east wall is a round window. A woven rug adorns the floor in the middle of the room. Along the west wall are a fridge and some shelves. A bed lies in the northwest corner, and a stove lies in the northeast.

On the stove is a frying pan.

On the shelves is a loaf of bread.

You can also see an apartment door, a backpack (empty), a dwarf banana tree, a fridge (closed) and the bed (on which are bedsheets and a pair of Central European panties) here.

>l window
Out the window you can see the Bay of Gentofte. Some way out in the water is a small island. From here it looks quite pleasant.

>gonear monk
Island of Technique
This little island is no tropical paradise. It's more like someone carved a chunk off of Scotland and dropped it at the edge of the bay. Foggy, muddy, and riddled with trees.

You can see a monk here.

>gonear window
Apartment
Your apartment is a cheery little box. On the east wall is a round window. A woven rug adorns the floor in the middle of the room. Along the west wall are a fridge and some shelves. A bed lies in the northwest corner, and a stove lies in the northeast.

On the stove is a frying pan.

On the shelves is a loaf of bread.

You can also see an apartment door, a backpack (empty), a dwarf banana tree, a fridge (closed) and the bed (on which are bedsheets and a pair of Central European panties) here.

>l window
Out the window you can see the Bay of Gentofte. Some way out in the water is a small island. From here it looks quite pleasant, but you know that it's actually kind of a shithole.

* * *

>gonearf ana
That's not a verb I recognize.

>gonear ana
IIT Campus
The campus is pretty sleepy in the summer. A construction crew works below the bell tower, but the only student you see is Ana.

You can see Ana and a stone bench here.

* * *

>touch ana
She slaps your hand away.

>press ana
She slaps your hand away.

>purloin red. give red
[Purloined.]

(to Ana)
Ana sighs and kisses your cheek. She strolls over to the bench, and sits down to gaze at the flower.

[Your score has just gone up by one point.]

>l ana
A Czech girl. Starting next week, she's your TA for Introductory Programming. Starting last night, she's your lover.

>take an
You can't see any such thing.

>take ana
You can't take a living thing!

* * *

>hel
That's not a verb I recognize.

>hehlp
That's not a verb I recognize.

>help
Study well this table:
look      - l for short
Describes the room you're in and what you perceive there. If you specify a direct object (e.g. 'l/look toy'), you'll get its detailed description.
take      - [no short form]
Picks something up to take with you.
inventory - i for short
Checks the items you're carrying with you.
dirs      - [no short form]
Lists the directions you can go from here.
wait      - r for short
Waits for one turn.
In general, remember to look at everything for clues and take anything you desire. Good luck!

* * *

>help
Study well this table:
look      - l   - Describes your immediate surroundings. For detailed descriptions, specify a direct object (e.g. 'l/look toy').
take      - N/A - Picks something up.
inventory - i   - Shows what you're carrying.
dirs      - N/A - Lists the directions you can go from here.
wait      - r   - Waits for one turn.

>hint
Useful keys: i to show inventory; x to examine. The author recommends examining things whenever possible.

* * *

>l toy
You can't see any such thing.

>help
Good fortune awaits you if you use these keys:
look  -  l  -  Describes the room you're in and what you perceive there. If you specify a direct object (e.g. 'l/look toy'), you'll get a more detailed description.
examine  -  x  -  Looks at a person or thing more closely to gain information.
take  -  take  -  Picks something up to take with you.
inventory  -  i  -  Checks the items you're carrying with you.
wait  -  r  -  Waits for one turn. Useful for anything time-based.
In general, remember to look at everything for clues and take anything you desire. Good luck!

>test bungo
(Testing.)

>[1] purloin steak
[Purloined.]

>[2] purloin flower
[Purloined.]

>[3] gonear ana
IIT Campus
The campus is pretty sleepy in the summer. A construction crew works below the bell tower, but the only student you see is Ana.

You can see Ana and a stone bench here.

>[4] give steak to ana
She slaps the steak out of your hand.

>[5] touch ana
She slaps your hand away.

>[6] kiss ana
She slaps the kiss right off your lips.

>[7] give flower to ana
Ana sighs and kisses your cheek. She strolls over to the bench, and sits down to gaze at the flower.

[Your score has just gone up by one point.]

>[8] touch ana
You caress her, and she rubs her head against your hand.

>[9] kiss ana
You plant your searching lips on her cheek, and she squeals in delight.

>kiss ana
You plant your quivering lips on her cheek, and she squeals in delight.

>kiss ana
You plant your quivering lips on her cheek, and she squeals in delight.

>kiss ana
You plant your searching lips on her cheek, and she squeals in delight.

>give ana a flower
(first taking the flower)
That seems to belong to Ana.

>take flower
That seems to belong to Ana.

* * *

>l window
Out the window you can see the Bay of Gentofte. Some way out in the water is a small island. From here it looks quite pleasant.

* * *

>load
That's not a verb I recognize.

>restore
Ok.

>transcript
Attempt to begin transcript failed.

* * *

>look
Apartment
Your apartment is a cheery little box. On the east wall is a round window. A woven rug adorns the floor in the middle of the room. Along the west wall are a fridge and some shelves. A bed lies in the northwest corner, and a stove lies in the northeast.

On the stove is a frying pan.

On the shelves is a loaf of bread.

You can also see a fridge (closed) and a bed (on which are bedsheets and a pair of Central European panties) here.

>get pan
Taken.

>put pan
(in the pan)
You can't put something inside itself.

>put pan on sove
You can't see any such thing.

>put pan on sove
You can't see any such thing.

>put pan on stove
You put the pan on the stove.

>i
You are carrying nothing.

* * *

>look
Apartment
Your apartment is a cheery little box. On the east wall is a round window. A woven rug adorns the floor in the middle of the room. Along the west wall are a fridge and some shelves. A bed lies in the northwest corner, and a stove lies in the northeast.

On the stove is a frying pan.

On the shelves is a loaf of bread.

You can also see a fridge (closed) and a bed (on which are bedsheets and a pair of Central European panties) here.

>look door
You can't see any such thing.

>x
What do you want to examine?

>door
You can't see any such thing.

>exits
That's not a verb I recognise.

>help
That's not a verb I recognise.

>?
That's not a verb I recognise.

* * *

>look
Apartment
Your apartment is a cheery little box. On the east wall is a round window. A woven rug adorns the floor in the middle of the room. Along the west wall are a fridge and some shelves. A bed lies in the northwest corner, and a stove lies in the northeast.

On the stove is a frying pan.

On the shelves is a loaf of bread.

You can also see a fridge (closed) and a bed (on which are bedsheets and a pair of Central European panties) here.

>look stove
You can't see any such thing.

* * *

>look bed
Shaped to perfectly fit the human body.

>look bread
You see nothing special about the loaf of bread.

* * *

>ls
That's not a verb I recognize.

>transcruipt
That's not a verb I recognize.

>transcript
Start of a transcript of

RYAN QUEST 2
An Interactive Fiction by Maxwell Joslyn
Release 1 / Serial number 181222 / Inform 7 build 6M62 (I6/v6.33 lib 6/12N) SD
Identification number: //EC20F892-AF27-40A2-8F4F-306D07A36092//
Interpreter version 0.5.2 / VM 3.1.2 / Library serial number 080126
Standard Rules version 3/120430 by Graham Nelson
Rideable Vehicles version 3 by Graham Nelson

>sf
That's not a verb I recognize.

>s
(first opening the apartment door)
You can't go to school without your backpack.

>a
That's not a verb I recognize.

>test bird
>--> The following tests are available:
'test bungo'
'test pack'
'test apt'
'test leave'
'test vendor'
'test bird-a'
'test docktoplatform'
'test uptodock'
'test wait-a'
'test trainto'
'test uptocope'
'test ana'
'test butt'
'test inside-tree'

>test bird-a
(Testing.)

>[1] e
You can't go that way.

>[2] feed pile to bird
You can't see any such thing.

>test pack
(Testing.)

>[1] get pack
Taken.

>test apt
(Testing.)

>[1] x fridge
Silver, yet subtle. The handle is quite affordant.

>[2] open fridge
You open the fridge, revealing a piece of cheese, a steak and a glass bottle.

>[3] x bottle
It contains some Dankdrinke.

In the glass bottle is some Dankdrinke.

>[4] open bottle
You open the glass bottle.

>[5] x dankdrinke
No drinke is more ergonomik than Dankdrinke!

>[6] drink dankdrinke
(first taking the Dankdrinke)
>[7] x sheets
Extremely rumpled from excessive romping.

>[8] x panties
Pink, frilly, and definitely not yours.

>[9] x rug
The rug depicts a scene of universal healthcare flying over a lake.

>[10] take panties
(putting the wallet into the backpack to make room)
Nice.

>[11] take banana tree
(putting the glass bottle into the backpack to make room)
Taken.

>test bird-a
(Testing.)

>[1] e
You can't go that way.

>[2] feed pile to bird
You can't see any such thing.

>test vendor
(Testing.)

>[1] buy pile
You can't see any such thing.

>[2] buy mound
You can't see any such thing.

>go outside
You can't go that way.

>take all
frying pan: (putting the pair of Central European panties into the backpack to make room)
Taken.
loaf of bread: (putting the dwarf banana tree into the backpack to make room)
Taken.
piece of cheese: (putting the frying pan into the backpack to make room)
Taken.
steak: (putting the loaf of bread into the backpack to make room)
Taken.
bedsheets: (putting the piece of cheese into the backpack to make room)
Taken.

>i
You are carrying:
  bedsheets
  a steak
  a backpack (open)
    a piece of cheese
    a loaf of bread
    a frying pan
    a dwarf banana tree
    a pair of Central European panties
    a glass bottle (open)
      some Dankdrinke
    a wallet
      5 kroner
      1 Uncle Sam

>s
(first opening the apartment door)

Hellerup Strandvejen
The main street of Hellerup is bordered on its north side by brightly-painted row houses, such as the one containing your apartment. At the east end is a dock, and if you go west you can catch a train.

You can see an apartment door, a street vendor and a wheelbarrow (in which are a pile of herring and a mound of herring) here.

The vendor calls out, "Today I have a pile of herring and a mound of herring! Fresh!"

>take all
wheelbarrow: That belongs to the street vendor.
pile of herring: That costs money.
mound of herring: That costs money.
fistful of herring: That seems to belong to the street vendor.

The vendor calls out, "Today I have a pile of herring and a mound of herring! Fresh!"

>buy all
You can't use multiple objects with that verb.

>buy
What do you want to buy?

>pile
You pay 1 kroner for the pile of herring, leaving yourself with 4 kroner.

The vendor calls out, "Today I have a mound of herring! Fresh!"

>buy mound
You pay 2 kroner for the mound of herring, leaving yourself with 2 kroner.

The vendor winks at you.

>buy fistful
That doesn't cost any money.
That seems to belong to the street vendor.

The vendor taps his foot.

>w
Train Platform
The open-air train platform has a line that runs to Copenhagen every 10 minutes. There are no tickets: it is free to ride.

You can see a wall sign and a paper kroner here.

>e
Hellerup Strandvejen
The main street of Hellerup is bordered on its north side by brightly-painted row houses, such as the one containing your apartment. At the east end is a dock, and if you go west you can catch a train.

You can see an apartment door, a street vendor and a wheelbarrow (empty) here.

>e
Dock
This is a shabby little dock used for the fishing trade. At the end of the dock, a little rowboat, moored with a rope, bobs up and down. In the rowboat is a large crate, atop which sits a bird.

>feed bird
What do you want to feed the wretched bird to?

>herring
Which do you mean, the herring crate, the mound of herring or the pile of herring?

>mound
(first taking the wretched bird)
You can't take a living thing!

>feed mound to bird
The wretched bird regards you warily, then opens its beak and snaps up the mound of herring. It swallows in one gulp.

You see a flash of brilliance in its black, beady eyes. Then it caws, and flies off in the direction of Copenhagen.

You feel strangely proud.

[Your score has just gone up by one point.]

>save
Ok.

>restore
Ok.

>transcript
Transcripting is already on.

>ls
That's not a verb I recognize.

>dong
That's not a verb I recognize.

>penis
That's not a verb I recognize.

>save
Ok.

>quit
Are you sure you want to quit?

* * *

>not
That's not a verb I recognize.

* * *

>open
What do you want to open?

>fridge
You open the fridge, revealing a piece of cheese, a steak and a glass bottle.

>take bottle
Taken.

>x bottle
In the glass bottle are some. Dankdrinke.

* * *

>open fridge
You open the fridge, revealing a piece of cheese, a steak and a glass bottle.

>help
Good fortune awaits you if you use these keys:
look - l - Describes the room you're in and what you perceive there.
examine - x - Looks at a person or thing more closely to gain information.
take - take - Picks something up to take with you.
inventory - i - Checks the items you're carrying with you.
wait - wait - Waits for one turn. Useful for anything time-based.
banter - banter - Just bloody try it bruv I swear on me grave
In general, examine everything for clues and take anything you can. Good luck!

* * *

>open fridge
You open the fridge, revealing a piece of cheese, a steak and a glass bottle.

>ook steak
That's not a verb I recognize.

>cook steak
Are you sure? You might need that later.

* * *

>cook steak
Are you sure? You might need that later.

>y
You cook the steak, filling the air with delicious smells.

>cook tree
Foolish American, have you truly mistaken a dwarf banana tree for food?.

>eat tree
That's definitely not edible.

* * *

>open fridge
You open the fridge, revealing a piece of cheese, a steak and a glass bottle.

>take cheese
Taken.

>close fridge
You close the fridge.

>take bread
Taken.

* * *

>take cheese
Taken.

>take steak
Taken.

* * *

>open fridge
You open the fridge, revealing a piece of cheese, a steak and a glass bottle.

>take pack
You take the backpack.

>take all
dwarf banana tree: You take the dwarf banana tree.
frying pan: (putting the wallet into the backpack to make room)
You take the frying pan.
loaf of bread: (putting the dwarf banana tree into the backpack to make room)
You take the loaf of bread.
piece of cheese: (putting the frying pan into the backpack to make room)
You take the piece of cheese.
steak: (putting the loaf of bread into the backpack to make room)
You take the steak.
glass bottle: (putting the piece of cheese into the backpack to make room)
You take the glass bottle.
Dankdrinke: The glass bottle isn't open.
bedsheets: (putting the steak into the backpack to make room)
You take bedsheets.
pair of Central European panties: (putting the glass bottle into the backpack to make room)
Nice.

>eat dankdrinke
The glass bottle isn't open.

* * *

>open fridge
You open the fridge, revealing a piece of cheese, a steak and a glass bottle.

>take stak
You can't see any such thing.

>take steak
Taken.

I beg your pardon?

>i
You are carrying:
  a steak
  a wallet
    5 kroner
    1 Uncle Sam

>eat steak
Are you sure? You might need that later. [y/n]

* * *

>open fridge
You open the fridge, revealing a piece of cheese, a steak and a glass bottle.

>take steak and cheese
steak: Taken.
piece of cheese: Taken.

>take dankdrinke
The glass bottle isn't open.

>i
You are carrying:
  a piece of cheese
  a steak
  a wallet
    5 kroner
    1 Uncle Sam

>take bottle
You're carrying too many things already.

>s
(first opening the apartment door)
You can't go to school without your backpack.

>drop cheese
Dropped.

>take pack
Taken.

>put cheese and steak in pack
piece of cheese: (first taking the piece of cheese)
(putting the wallet into the backpack to make room)
Done.
steak: Done.

>take bottle
Taken.

>drink bottle
You open the glass bottle.

(first taking the Dankdrinke)
You already have that.

>eat dankdrinke
(first taking the Dankdrinke)
You already have that.

>drink dankdrinke
(first taking the Dankdrinke)
You already have that.

>i
You are carrying:
  a glass bottle (open)
    some Dankdrinke
  a backpack (open)
    a steak
    a piece of cheese
    a wallet
      5 kroner
      1 Uncle Sam

>take all
dwarf banana tree: frying pan: (putting the glass bottle into the backpack to make room)
Taken.
loaf of bread: (putting the dwarf banana tree into the backpack to make room)
Taken.
bedsheets: (putting the frying pan into the backpack to make room)
Taken.
pair of Central European panties: (putting the loaf of bread into the backpack to make room)
Nice.

>s
(first opening the apartment door)

Hellerup Strandvejen
The main street of Hellerup is bordered on its north side by brightly-painted row houses, such as the one containing your apartment. At the east end is a dock, and if you go west you can catch a train.

You can see an apartment door, a street vendor and a wheelbarrow (in which are a pile of herring and a mound of herring) here.

The vendor calls out, "Today I have a pile of herring and a mound of herring! Fresh!"

>gonear bench
IIT Campus
The campus is pretty sleepy in the summer. A construction crew works below the bell tower, but the only student you see is Ana.

You can see Ana and a stone bench here.

>i
You are carrying:
  a pair of Central European panties
  bedsheets
  a backpack (open)
    a loaf of bread
    a frying pan
    a dwarf banana tree
    a glass bottle (open)
      some Dankdrinke
    a steak
    a piece of cheese
    a wallet
      5 kroner
      1 Uncle Sam

>purloin flower
[Purloined.]

>i
You are carrying:
  a flower
  a pair of Central European panties
  bedsheets
  a backpack (open)
    a loaf of bread
    a frying pan
    a dwarf banana tree
    a glass bottle (open)
      some Dankdrinke
    a steak
    a piece of cheese
    a wallet
      5 kroner
      1 Uncle Sam

>purloin flower
[Purloined.]

I beg your pardon?

>i
You are carrying:
  a flower
  a pair of Central European panties
  bedsheets
  a backpack (open)
    a loaf of bread
    a frying pan
    a dwarf banana tree
    a glass bottle (open)
      some Dankdrinke
    a steak
    a piece of cheese
    a wallet
      5 kroner
      1 Uncle Sam

>purloin 2 flowers
There seems to be no such object anywhere in the model world.

>i
You are carrying:
  a flower
  a pair of Central European panties
  bedsheets
  a backpack (open)
    a loaf of bread
    a frying pan
    a dwarf banana tree
    a glass bottle (open)
      some Dankdrinke
    a steak
    a piece of cheese
    a wallet
      5 kroner
      1 Uncle Sam

>s
You can't go that way.

* * *

>e
You can't go that way.

>a
That's not a verb I recognize.

>s
You can't go that way.

>n
Copenhagen Metro Station
This is the main metro station in Copenhagen. Its creator won the Best Dane of the Year Award.

Stairs lead southward and upward to the IIT Campus exit. Christiana is northwest of here: this much you know.

The Danes are very efficient: you can also take a direct route west from here to the Aarenhus Cemetery.

A small door stands in the southeast corner of the station near a fake tree.

You can see the fake tree (closed) here.

>w
Aarenhus Cemetery
Dark paths run here and there among the marble tombs. Some trees provide relaxing shade, and white flowers bloom here and there.

You can see a few flowers here.

>take lfower
You can't see any such thing.

>take flower
You pluck a flower from where it grows.

>e
Copenhagen Metro Station
This is the main metro station in Copenhagen. Its creator won the Best Dane of the Year Award.

Stairs lead southward and upward to the IIT Campus exit. Christiana is northwest of here: this much you know.

The Danes are very efficient: you can also take a direct route west from here to the Aarenhus Cemetery.

A small door stands in the southeast corner of the station near a fake tree.

You can see the fake tree (closed) here.

>s
IIT Campus
The campus is pretty sleepy in the summer. A construction crew works below the bell tower, but the only student you see is Ana.

You can see Ana and a stone bench here.

* * *

>give flower ana
You can only do that to something animate.

>give flower to ana
Ana sighs and kisses your cheek. She strolls over to the bench, and sits down to gaze at the flower.

[Your score has just gone up by one point.]

>give flower to ana
Ana giggles.

>give ana a flower
Ana grins.

>give ana flower
Ana blushes.

>give ana panties
She blushes, snatches the pair of Central European panties, and flounces off.

[Your score has just gone up by one point.]

>i
You are carrying:
  bedsheets
  a backpack (open)
    a loaf of bread
    a frying pan
    a dwarf banana tree
    a glass bottle (open)
      some Dankdrinke
    a steak
    a piece of cheese
    a wallet
      5 kroner
      1 Uncle Sam

>eat cheese and steak
You can't use multiple objects with that verb.

>eat cheese
(first taking the piece of cheese)
You eat the piece of cheese. Not bad.

>eat steak
(first taking the steak)
You eat the steak. Not bad.

* * *

>open fridge
You open the fridge, revealing a piece of cheese, a steak and a glass bottle.

>x bottle
In the glass bottle is some Dankdrinke.

>drink bottle
There's nothing suitable to drink here.

* * *

>open fridge
You open the fridge, revealing a piece of cheese, a steak and a glass bottle.

>x steak
A gift from your landlady: she's rented to Americans before.

>take steak
Taken.

>i
You are carrying:
  a steak
  a wallet
    5 kroner
    1 Uncle Sam

* * *

>x steak
A gift from your landlady: she's rented to Americans before.

>x cheese
Purchased in the market on Brandstrasse.

>x bottle
In the glass bottle is some Dankdrinke.

* * *

>open fridge. eat steak
You open the fridge, revealing a piece of cheese, a steak and a glass bottle.

That's definitely not edible.

>cook steak
You cook the steak, filling the air with delicious smells.

[Your score has just gone up by one point.]

>eat steak
(first taking the steak)
You eat the steak. Not bad.

* * *

>open fridge. take steak
You open the fridge, revealing a piece of cheese, a steak and a glass bottle.

Taken.

>eat steak
Are you sure? You might need that later. [y/n]

>y
You'll have to cook it first.

>i
You are carrying:
  a steak
  a wallet
    5 kroner
    1 Uncle Sam

>cook steak
You cook the steak, filling the air with delicious smells.

[Your score has just gone up by one point.]

>eat steak
Are you sure? You might need that later. [y/n]

>y
You eat the steak. Not bad.

* * *

>piss
That's not a verb I recognize.

>transcript
Start of a transcript of

RYAN QUEST 2
An Interactive Fiction by Maxwell Joslyn
Release 1 / Serial number 181222 / Inform 7 build 6M62 (I6/v6.33 lib 6/12N) SD
Identification number: //EC20F892-AF27-40A2-8F4F-306D07A36092//
Interpreter version 0.5.2 / VM 3.1.2 / Library serial number 080126
Standard Rules version 3/120430 by Graham Nelson
Rideable Vehicles version 3 by Graham Nelson

>piss
That's not a verb I recognize.

>take pack
Taken.

>take all
dwarf banana tree: Taken.
frying pan: (putting the wallet into the backpack to make room)
Taken.
loaf of bread: (putting the dwarf banana tree into the backpack to make room)
Taken.
bedsheets: (putting the frying pan into the backpack to make room)
Taken.
pair of Central European panties: (putting the loaf of bread into the backpack to make room)
Nice.

>s
(first opening the apartment door)

Hellerup Strandvejen
The main street of Hellerup is bordered on its north side by brightly-painted row houses, such as the one containing your apartment. At the east end is a dock, and if you go west you can catch a train.

You can see an apartment door, a street vendor and a wheelbarrow (in which are a pile of herring and a mound of herring) here.

>w
Train Platform
The open-air train platform has a line that runs to Copenhagen every 10 minutes. There are no tickets: it is free to ride.

You can see a C-Train (in which is a wrap-around sofa), a wall sign and a paper kroner here.

>take all
paper kroner: You gain 1 kroner.

>enter train
You get into the C-Train.

In the C-Train you can see a wrap-around sofa.

The C-Train departs, taking you into a tunnel.

>l
Train Tunnel (in the C-Train)
This underwater transit tunnel represents a feat of engineering. Its creator won the Most Illustrious Dane medal.

In the C-Train you can see a wrap-around sofa.

You arrive in Copenhagen.

* * *

>exit
Copenhagen Metro Station
This is the main metro station in Copenhagen. Its creator won the Best Dane of the Year Award.

Stairs lead southward and upward to the IIT Campus exit. Christiana is northwest of here: this much you know.

The Danes are very efficient: you can also take a direct route west from here to the Aarenhus Cemetery.

A small door stands in the southeast corner of the station near a fake tree.

You can see a C-Train (in which is a wrap-around sofa) and the fake tree here.

>save
Ok.

>load
That's not a verb I recognize.

* * *

>restore
Ok.

>dick
That's not a verb I recognize.

>assholio
That's not a verb I recognize.

>take all
There are none at all available!

>buy al
You can't see any such thing.

>buy
What do you want to buy?

>money
The money belongs to you, and you buy things with it.

>i
You are carrying:
  a pair of Central European panties
  bedsheets
  a backpack (open)
    a loaf of bread
    a frying pan
    a dwarf banana tree
    a wallet
      6 kroner
      1 Uncle Sam

>quit
Are you sure you want to quit?

* * *

>prepared
That's not a verb I recognize.

>prepare
That's not a verb I recognize.

* * *

>press button
You can't see any such thing.

>gonear an
There seems to be no such object anywhere in the model world.

>gonear ana
IIT Campus
The campus is pretty sleepy in the summer. A construction crew works below the bell tower, but the only student you see is Ana.

You can see Ana and a stone bench here.

* * *

>touch ana
She slaps your hand away.

>kiss ana
She slaps the kiss right off your lips.

>purloin red. give red
[Purloined.]

(to Ana)
Ana sighs and kisses your cheek. She strolls over to the bench, and sits down to gaze at the flower.

[Your score has just gone up by one point.]

>x ana
A Czech girl. Starting next week, she's your TA for Introductory Programming. Starting last night, she's your lover.

>kiss ana
You plant your soft lips on her cheek, and she wiggles in delight.

>touch ana
You caress her, and she rubs her head against your hand.

* * *

>press ana
You caress her, and she rubs her head against your hand.

>push ana
Ana might not like that.

* * *

>pull handle
You open the fridge, revealing a piece of cheese, a steak and a glass bottle.

>push handle
You close the fridge.

>x fridge
Silver, yet subtle. The handle is quite affordant..

>test pack. test apt
(Testing.)

(Testing.)

>[1] x fridge
Silver, yet subtle. The handle is quite affordant..

>[2] open fridge
You open the fridge, revealing a piece of cheese, a steak and a glass bottle.

>[3] x bottle
It contains some Dankdrinke.

In the glass bottle is some Dankdrinke.

>[4] open bottle
You open the glass bottle.

>[5] x dankdrinke
No drinke is more ergonomik than Dankdrinke!

>[6] drink dankdrinke
(first taking the Dankdrinke)
Your throat is filled with ergonomitivity.

[Your score has just gone up by one point.]

>[7] x sheets
Extremely rumpled from excessive romping.

>[8] x panties
Pink and frilly. They belong to a girl named Ana.

>[9] x rug
The rug depicts a scene of universal healthcare flying over a lake.

>[10] take panties
Nice.

>[11] take banana tree
Taken.

>[12] get pack
You're carrying too many things already.

>s
(first opening the apartment door)
You can't go to school without your backpack.

>drop tree
Dropped.

>e pack
I only understood you as far as wanting to (go) e.

>drop all
pair of Central European panties: Dropped.
wallet: Dropped.

>take pack
Taken.

>i
You are carrying:
  a backpack (open but empty)

>take panties. take steak. take walet
Taken.

Taken.

You can't see any such thing.

>take panties. take steak. take wallet
You already have that.

You already have that.

(putting the pair of Central European panties into the backpack to make room)
Taken.

>i
You are carrying:
  a wallet
    5 kroner
    1 Uncle Sam
  a steak
  a backpack (open)
    a pair of Central European panties

>l
Apartment
Your apartment is a cheery little box. On the east wall is a round window. A woven rug adorns the floor in the middle of the room. Along the west wall are a fridge and some shelves. A bed lies in the northwest corner, and a stove lies in the northeast.

On the stove is a frying pan.

On the shelves is a loaf of bread.

You can also see a dwarf banana tree, an apartment door, a fridge (in which are a piece of cheese and a glass bottle (empty)) and the bed (on which is bedsheets) here.

>l pan
Danish engineering makes bad food an impossibility.

>help
Good fortune awaits you if you use these keys:
look  -  l  -  Describes the room you're in and what you perceive there.
examine  -  x  -  Looks at a person or thing more closely to gain information.
take  -  take  -  Picks something up to take with you.
inventory  -  i  -  Checks the items you're carrying with you.
wait  -  r  -  Waits for one turn. Useful for anything time-based.
In general, remember to examine everything for clues and take anything you desire. Good luck!

>fuck
That's not a verb I recognize.

>s
(first opening the apartment door)

Hellerup Strandvejen
The main street of Hellerup is bordered on its north side by brightly-painted row houses, such as the one containing your apartment. At the east end is a dock, and if you go west you can catch a train.

You can see an apartment door, a street vendor and a wheelbarrow (in which are a pile of herring and a mound of herring) here.

>n
Apartment
Your apartment is a cheery little box. On the east wall is a round window. A woven rug adorns the floor in the middle of the room. Along the west wall are a fridge and some shelves. A bed lies in the northwest corner, and a stove lies in the northeast.

On the stove is a frying pan.

On the shelves is a loaf of bread.

You can also see an apartment door, a dwarf banana tree, a fridge (in which are a piece of cheese and a glass bottle (empty)) and the bed (on which is bedsheets) here.

>test bird
>--> The following tests are available:
'test pack'
'test apt'
'test leave'
'test vendor'
'test bird-a'
'test docktoplatform'
'test uptodock'
'test wait-a'
'test trainto'
'test uptocope'
'test ana'

>test bird-a
(Testing.)

>[1] e
You can't go that way.

>[2] feed pile to bird
You can't see any such thing.

>s
Hellerup Strandvejen
The main street of Hellerup is bordered on its north side by brightly-painted row houses, such as the one containing your apartment. At the east end is a dock, and if you go west you can catch a train.

You can see an apartment door, a street vendor and a wheelbarrow (in which are a pile of herring and a mound of herring) here.

>e
Dock
This is a shabby little dock used for the fishing trade. At the end of the dock, a little rowboat, moored with a rope, bobs up and down. In the rowboat is a large crate, atop which sits a bird.

>e
You can't go that way.

>w
Hellerup Strandvejen
The main street of Hellerup is bordered on its north side by brightly-painted row houses, such as the one containing your apartment. At the east end is a dock, and if you go west you can catch a train.

You can see an apartment door, a street vendor and a wheelbarrow (in which are a pile of herring and a mound of herring) here.

I beg your pardon?

>w
Train Platform
The open-air train platform has a line that runs to Copenhagen every 10 minutes. There are no tickets: it is free to ride.

You can see a paper kroner here.

>e
Hellerup Strandvejen
The main street of Hellerup is bordered on its north side by brightly-painted row houses, such as the one containing your apartment. At the east end is a dock, and if you go west you can catch a train.

You can see an apartment door, a street vendor and a wheelbarrow (in which are a pile of herring and a mound of herring) here.

>buy pile. buy vendor
You pay 1 kroner for the pile of herring, leaving yourself with 4 kroner.

That doesn't cost any money.
You can't take a living thing!

The vendor calls out, "Today I have a mound of herring! Fresh!"

>buy mound
You pay 2 kroner for the mound of herring, leaving yourself with 2 kroner.

>i
You are carrying:
  a mound of herring
  a pile of herring
  a wallet
    2 kroner
    1 Uncle Sam
  a steak
  a backpack (open)
    a pair of Central European panties

>i
You are carrying:
  a mound of herring
  a pile of herring
  a wallet
    2 kroner
    1 Uncle Sam
  a steak
  a backpack (open)
    a pair of Central European panties

The vendor winks at you.

>x
What do you want to examine?

>vendor
A friendly purveyor of herring, and perhaps more. He wears a long coat, a fingerless glove, a pair of trousers and a pair of sneakers.

>w
Train Platform
The open-air train platform has a line that runs to Copenhagen every 10 minutes. There are no tickets: it is free to ride.

You can see a paper kroner here.

>e
Hellerup Strandvejen
The main street of Hellerup is bordered on its north side by brightly-painted row houses, such as the one containing your apartment. At the east end is a dock, and if you go west you can catch a train.

You can see an apartment door, a street vendor and a wheelbarrow (empty) here.

I beg your pardon?

>i
You are carrying:
  a mound of herring
  a pile of herring
  a wallet
    2 kroner
    1 Uncle Sam
  a steak
  a backpack (open)
    a pair of Central European panties

>w
Train Platform
The open-air train platform has a line that runs to Copenhagen every 10 minutes. There are no tickets: it is free to ride.

You can see a C-Train (in which is a wrap-around sofa) and a paper kroner here.

I beg your pardon?

>w
You can't go that way.

>e. e.
Hellerup Strandvejen
The main street of Hellerup is bordered on its north side by brightly-painted row houses, such as the one containing your apartment. At the east end is a dock, and if you go west you can catch a train.

You can see an apartment door, a street vendor and a wheelbarrow (empty) here.

Dock
This is a shabby little dock used for the fishing trade. At the end of the dock, a little rowboat, moored with a rope, bobs up and down. In the rowboat is a large crate, atop which sits a bird.

>feed bird
What do you want to feed the wretched bird to?

I beg your pardon?

>np
You can't see any such thing.

>give herring to bird
Which do you mean, the mound of herring, the pile of herring or the herring crate?

>pil
You can't see any such thing.

>give herring to bird
Which do you mean, the mound of herring, the pile of herring or the herring crate?

>pile
The wretched bird regards you warily, then opens its beak and snaps up the pile of herring. It swallows in one gulp.

You see a flash of brilliance in its black, beady eyes. Then it caws, and flies off in the direction of Copenhagen.

You feel strangely proud.

[Your score has just gone up by one point.]

>i
You are carrying:
  a mound of herring
  a wallet
    2 kroner
    1 Uncle Sam
  a steak
  a backpack (open)
    a pair of Central European panties

>take create
You can't see any such thing.

>take crate
That's fixed in place.

>l
Dock
This is a shabby little dock used for the fishing trade. At the end of the dock, a little rowboat, moored with a rope, bobs up and down. In the rowboat is a large crate, atop which sits a bird.

>l rope
Soaked and salty, but somehow still sturdy.

>take rope
That's hardly portable.

* * *

>purloin fake tree
[Purloined.]

>i
You are carrying:
  the fake tree (closed and locked)
  a wallet
    5 kroner
    1 Uncle Sam

* * *

>purloin pile
[Purloined.]

>take pack
Taken.

>s
(first opening the apartment door)

Hellerup Strandvejen
The main street of Hellerup is bordered on its north side by brightly-painted row houses, such as the one containing your apartment. At the east end is a dock, and if you go west you can catch a train.

You can see an apartment door, a street vendor and a wheelbarrow (in which is a mound of herring) here.

The vendor calls out, "Today I have a mound of herring! Fresh!"

>e
Dock
This is a shabby little dock used for the fishing trade. At the end of the dock, a little rowboat, moored with a rope, bobs up and down. In the rowboat is a large crate, atop which sits a bird.

>purloin steak
[Purloined.]

>feed steak to bird
A steak is much too good for the wretched bird.

>feed herring to bird
(the pile of herring to the wretched bird)
The wretched bird regards you warily, then opens its beak and snaps up the pile of herring. It swallows in one gulp.

You see a flash of brilliance in its black, beady eyes. Then it caws, and flies off in the direction of Copenhagen.

You feel strangely proud.

[Your score has just gone up by one point.]

* * *

>purloin pile. gonear wretched. feed bird.
[Purloined.]

Dock
This is a shabby little dock used for the fishing trade. At the end of the dock, a little rowboat, moored with a rope, bobs up and down. In the rowboat is a large crate, atop which sits a bird.

I didn't understand that sentence.

>feed herring to bird
(the pile of herring to the wretched bird)
The wretched bird regards you warily, then opens its beak and snaps up the pile of herring. It swallows in one gulp.

You see a flash of brilliance in its black, beady eyes. Then it caws, and flies off in the direction of Copenhagen.

You feel strangely proud.

[Your score has just gone up by one point.]

>enter crate
(getting into the rowboat)
It's much too slippery for a landlubber like you to get in.

>get on crate
(getting into the rowboat)
It's much too slippery for a landlubber like you to get in.

* * *

>purloin steak
[Purloined.]

>purloin flower
[Purloined.]

>gonear ana
IIT Campus
The campus is pretty sleepy in the summer. A construction crew works below the bell tower, but the only student you see is Ana.

You can see Ana and a stone bench here.

* * *

>touch ana
She slaps your hand away.

>give ana flower
Ana sighs and kisses your cheek. She strolls over to the bench, and sits down to gaze at the flower.

[Your score has just gone up by one point.]

>touch ana
You caress her, and she leans her head against your hand.

Ana might not like that.

* * *

>push fridge
It is fixed in place.

>get pack
Taken.

* * *

>go south
(first opening the apartment door)

Hellerup Strandvejen
The main street of Hellerup is bordered on its north side by brightly-painted row houses, such as the one containing your apartment. At the east end is a dock, and if you go south you can catch a train.

You can see a street vendor and a wheelbarrow (in which are a pile of herring and a mound of herring) here.

>push wheelbarrow
Nothing obvious happens.

* * *

>r
Time passes.

>test bird
(Testing.)

>[1] test apt
(Testing.)

>[2] x fridge
Silver, yet subtle. The handle is quite affordant..

>[3] open fridge
You open the fridge, revealing a piece of cheese, a steak and a glass bottle.

>[4] x bottle
It contains some Dankdrinke.

In the glass bottle is some Dankdrinke.

>[5] open bottle
You open the glass bottle.

>[6] x dankdrinke
No drinke is more ergonomik than Dankdrinke!

>[7] drink dankdrinke
(first taking the Dankdrinke)
Your throat is filled with ergonomitivity.

[Your score has just gone up by one point.]

>[8] x sheets
Extremely rumpled from excessive romping.

>[9] x panties
Pink and frilly. You should probably return those.

>[10] x rug
The rug depicts a scene of universal healthcare flying over a lake.

>[11] take panties
Nice.

[Your score has just gone up by one point.]

>[12] take steak
Taken.

>[13] test leave
(Testing.)

>[14] get pack
Taken.

>[15] go south
(first opening the apartment door)

Hellerup Strandvejen
The main street of Hellerup is bordered on its north side by brightly-painted row houses, such as the one containing your apartment. At the east end is a dock, and if you go west you can catch a train.

You can see a street vendor and a wheelbarrow (in which are a pile of herring and a mound of herring) here.

The vendor eyes your steak.

>[16] buy pile of herring
You pay 1 kroner for the pile of herring, leaving yourself with 4 kroner.

The vendor eyes your wallet.

>[17] feed herring to vendor
(the pile of herring to the street vendor)
The street vendor is not willing to be fed by you.

The vendor eyes your steak.

>[18] east

Dock
This is a shabby little dock used for the fishing trade. At the end of the dock, a little rowboat, moored with a rope, bobs up and down. In the rowboat is a large crate, atop which sits a bird.

>[19] look
Dock
This is a shabby little dock used for the fishing trade. At the end of the dock, a little rowboat, moored with a rope, bobs up and down. In the rowboat is a large crate, atop which sits a bird.

>[20] feed panties to bird
Unlike you, the wretched bird is entirely unmotivated by sexy underwear.

>[21] feed herring to bird
(the pile of herring to the wretched bird)
The bird regards you warily, then opens its beak and snaps up the pile of herring. It swallows in one gulp.

You see a flash of brilliance in its black, beady eyes. Then it caws, and flies off in the direction of Copenhagen.

You feel strangely proud.

[Your score has just gone up by two points.]

>test cembird
(first moving to Aarenhus Cemetery)

(first acquiring the pile of herring)
(Testing.)

>[1] test bird
(first moving to Apartment)

(Testing.)

>[2] test apt
(Testing.)

>[3] x fridge
Silver, yet subtle. The handle is quite affordant..

In the fridge are a piece of cheese and a glass bottle.

>[4] open fridge
That's already open.

>[5] x bottle
It contains nothing.

>[6] open bottle
That's already open.

>[7] x dankdrinke
You can't see any such thing.

>[8] drink dankdrinke
You can't see any such thing.

>[9] x sheets
Extremely rumpled from excessive romping.

>[10] x panties
Pink and frilly. You should probably return those.

>[11] x rug
The rug depicts a scene of universal healthcare flying over a lake.

>[12] take panties
You already have that.

>[13] take steak
You already have that.

>[14] test leave
(Testing.)

>[15] get pack
You already have that.

>[16] go south

Hellerup Strandvejen
The main street of Hellerup is bordered on its north side by brightly-painted row houses, such as the one containing your apartment. At the east end is a dock, and if you go west you can catch a train.

You can see a street vendor and a wheelbarrow (in which is a mound of herring) here.

The vendor eyes your backpack.

>[17] buy pile of herring
That doesn't cost any money.
You already have that.

The vendor eyes your backpack.

>[18] feed herring to vendor
(the pile of herring to the street vendor)
The street vendor is not willing to be fed by you.

The vendor eyes your steak.

>[19] east

Dock
This is a shabby little dock used for the fishing trade. At the end of the dock, a little rowboat, moored with a rope, bobs up and down. In the rowboat is a large crate, atop which sits a bird.

>[20] look
Dock
This is a shabby little dock used for the fishing trade. At the end of the dock, a little rowboat, moored with a rope, bobs up and down. In the rowboat is a large crate, atop which sits a bird.

>[21] feed panties to bird
You can't see any such thing.

>[22] feed herring to bird
You can't see any such thing.

>[23] feed herring to bird
You can't see any such thing.

I beg your pardon?

>restart
Are you sure you want to restart?

>y
It is the Year of Our Lord MMXVIII. You have arrived in the Danish city of Copenhagen to pursue a master's degree. You found an apartment for let in the suburb of Hellerup, and promptly moved in. The place isn't much, but for the next two years it's home. 

PREPARE YOUR SPIRIT FOR . . .

RYAN QUEST 2
An Interactive Fiction by Maxwell Joslyn
Release 1 / Serial number 181116 / Inform 7 build 6M62 (I6/v6.33 lib 6/12N) SD

Apartment
Your apartment is a cheery little box. On the east wall is a round window. A woven rug adorns the floor in the middle of the room. Along the west wall are a fridge and some shelves. A bed lies in the northwest corner, and a stove lies in the northeast.

On the stove is a frying pan.

On the shelves is a loaf of bread.

You can also see a backpack (empty), a dwarf banana tree, a fridge (closed) and the bed (on which are bedsheets and a pair of Central European panties) here.

>test cembird
(first moving to Aarenhus Cemetery)

(first acquiring the pile of herring)
(Testing.)

>[1] test bird
(first moving to Apartment)

(Testing.)

>[2] test apt
(Testing.)

>[3] x fridge
Silver, yet subtle. The handle is quite affordant..

>[4] open fridge
You open the fridge, revealing a piece of cheese, a steak and a glass bottle.

>[5] x bottle
It contains some Dankdrinke.

In the glass bottle is some Dankdrinke.

>[6] open bottle
You open the glass bottle.

>[7] x dankdrinke
No drinke is more ergonomik than Dankdrinke!

>[8] drink dankdrinke
(first taking the Dankdrinke)
Your throat is filled with ergonomitivity.

[Your score has just gone up by one point.]

>[9] x sheets
Extremely rumpled from excessive romping.

>[10] x panties
Pink and frilly. You should probably return those.

>[11] x rug
The rug depicts a scene of universal healthcare flying over a lake.

>[12] take panties
Nice.

[Your score has just gone up by one point.]

>[13] take steak
Taken.

>[14] test leave
(Testing.)

>[15] get pack
You're carrying too many things already.

>[16] go south
(first opening the apartment door)
You can't go to school without your backpack.

>[17] buy pile of herring
You pay 1 kroner for the pile of herring, leaving yourself with 4 kroner.

>[18] feed herring to vendor
You can't see any such thing.

>[19] east
You can't go that way.

>[20] look
Apartment
Your apartment is a cheery little box. On the east wall is a round window. A woven rug adorns the floor in the middle of the room. Along the west wall are a fridge and some shelves. A bed lies in the northwest corner, and a stove lies in the northeast.

On the stove is a frying pan.

On the shelves is a loaf of bread.

You can also see a backpack (empty), a dwarf banana tree, a fridge (in which are a piece of cheese and a glass bottle (empty)) and the bed (on which is bedsheets) here.

>[21] feed panties to bird
You can't see any such thing.

>[22] feed herring to bird
You can't see any such thing.

>[23] feed herring to bird
You can't see any such thing.

I beg your pardon?

* * *

>score
You have so far scored 0 out of a possible 0, in 1 turn.

>x
What do you want to examine?

>test me
(Testing.)

>[1] x fridge
The handle is quite affordant.

>[2] open fridge
You open the fridge, revealing a piece of cheese, a steak and a glass bottle.

>[3] x bottle
In the glass bottle is some Dankdrinke.

>[4] open bottle
You open the glass bottle.

>[5] x dankdrinke
No drinke is more ergönomik than Dankdrinke!

>[6] drink dankdrinke
(first taking the Dankdrinke)
You gulp the Dankdrinke.

[Your score has just gone up by one point.]

>score
You have so far scored 1 out of a possible 0, in 7 turns.

* * *

>showme maximum score
There seems to be no such object anywhere in the model world.

* * *

>smoke tree
(first taking the dwarf banana tree)
You don't want to smoke the dwarf banana tree.

>x tree
As friendly as a plant can get, and eminently pocketable.

>cook steak
You can't see any such thing.

* * *

>open fridge
You open the fridge, revealing a piece of cheese, a steak and a glass bottle.

>cook steak
Are you sure? You might need that later.

>y
You cook the steak, filling the air with delicious smells.

[Your score has just gone up by one point.]

>eat steak
(first taking the steak)
You eat the steak. Not bad.

>take steak
You can't see any such thing.

>purloin steak
[Purloined.]

>i
You are carrying:
  a steak
  a dwarf banana tree
  a wallet
    5 kroner
    1 Uncle Sam

>cook steak
Are you sure? You might need that later.

>y
You cook the steak, filling the air with tasty smells.

>gonear bald eagle
Limbo
You can see the bald eagle and the friendly bird here.

>give steak to eagle
The bald eagle is is free from all desire.

>move friendly bird to path
You can't see any such thing.

>i
You are carrying:
  a steak
  a dwarf banana tree
  a wallet
    5 kroner
    1 Uncle Sam

* * *

>i
You are carrying:
  a dwarf banana tree
  a wallet
    5 kroner
    1 Uncle Sam

>l
Limbo
You can see the bald eagle and the friendly bird here.

>give steak to friendly bird
You can't see any such thing.

* * *

>south
(first opening the apartment door)
You can't go to school without your backpack.

* * *

>get pack
Taken.

>get panties
Nice.

[Your score has just gone up by one point.]

>pull handle
You open the fridge, revealing a piece of cheese, a steak and a glass bottle.

>get bottle
Taken.

>drink dankdrinke
The glass bottle isn't open.

>open bottle
You open the glass bottle.

>drink dankdrinke
(first taking the Dankdrinke)
(putting the wallet into the backpack to make room)
Your throat is filled with ergonomitivity.

[Your score has just gone up by one point.]

>x bottle
The glass bottle is empty.

>x dankdrinke
You can't see any such thing.

* * *

>south
(first opening the apartment door)
You can't go to school without your backpack.

>ls
That's not a verb I recognise.

>look
apartment door

>go south
Hellerup Main Street

>doors
That's not a verb I recognise.

* * *

>south
(first opening the apartment door)
You can't go to school without your backpack.

>x vndor
You can't see any such thing.

>x shoes
You can't see any such thing.

>x snekers
You can't see any such thing.

>x sneakers
Stained.

* * *

>spirit
That's not a verb I recognize.

>x spirit
You can't see any such thing.

* * *

>switch lightswitch
You switch the lightswitch off.

* * *

>switch on
What do you want to switch on?

>lightswitch
That's already on.

>switch off
What do you want to switch off?

>lightswitch
You switch the lightswitch off.

It is now pitch dark in here!

>look
Darkness
It is pitch dark, and you can't see a thing.

>switch on lightswitch
You can't see any such thing.

>switch on
What do you want to switch on?

>lightswitch
You can't see any such thing.

>look
Darkness
It is pitch dark, and you can't see a thing.

>x
What do you want to examine?

>lightswitch
You can't see any such thing.

* * *

>take ack
You can't see any such thing.

>take pack
You take the backpack.

>test at
>--> The following tests are available:
'test bungo'
'test pack'
'test apt'
'test leave'
'test vendor'
'test bird-a'
'test docktoplatform'
'test uptodock'
'test wait-a'
'test trainto'
'test uptocope'
'test ana'
'test butt'
'test inside-tree'

* * *

>take bread
You take the loaf of bread.

>eat bread
You eat the loaf of bread. Not bad.

>eat shelves
They're plainly inedible.

>eat bed
You can't see any such thing.

>look rgu
You can't see any such thing.

>look rug
The rug depicts a scene of birds flying over a lake.

>x rug
The rug depicts a scene of birds flying over a lake.

>x
(the shelves)
You see nothing special about the shelves.

>x room
You can't see any such thing.

>x apartment
You can't see any such thing.

>look
Apartment
Your apartment is lit by a pleasantly-shaped Danish light fixture. A woven rug adorns the floor in the middle of the room. Along the west wall are a fridge and some shelves. A bed lies in the northwest corner.

On the stove is a pan.

You can also see some shelves here.

>look stove
A two-burner electric stove.

On the stove is a pan.

* * *

>take bread
You take the loaf of bread.

>g frying pan
You already have that.

>get pan
Taken.

>g
You already have that.

>i
You are carrying:
  a frying pan
  a loaf of bread

>g shees
You are carrying:
  a frying pan
  a loaf of bread

>g sheets
You are carrying:
  a frying pan
  a loaf of bread

>get sheets
You can't see any such thing.

>bedsheets
That's not a verb I recognize.

>get bedsheets
Taken.

>i
You are carrying:
  bedsheets
  a frying pan
  a loaf of bread

>get backpack
You're carrying too many things already.

>drop sheets
You can't see any such thing.

>discard sheets
You can't see any such thing.

>i
You are carrying:
  bedsheets
  a frying pan
  a loaf of bread

* * *

>take bread
You take the loaf of bread.

>take panties
Nice.

>eat panties
Foolish American, have you truly mistaken the pair of Central European panties for food?

>smell panties
Pervert.

* * *

>take kroner
No need to do anything with that until you want to buy something.

>purloin paper kroner
[Purloined.]

>drop paper kroner
Dropped.

>take kroner
(the paper kroner)
You gain 1 kroner.

>take money
No need to do anything with that until you want to buy something.

>eat money
That's definitely not edible.

>gonear tombs
Aarenhus Cemetery
Dark paths run here and there among the marble tombs. Some trees provide relaxing shade, and white flowers bloom here and there.

You can see several flowers here.

>rest
That's not a verb I recognize.

>relax
Here in the cemetery, surrounded by memories of good Danes past, you take a deep breath and let it out slowly. Tension disappears from your body.

[Secret achieved.]
[Your score has just gone up by one point.]

>d
You can't go that way.

* * *

>take pack
You take the backpack.

>open fridge. take all
You open the fridge, revealing a piece of cheese, a steak and a glass bottle.

dwarf banana tree: frying pan: (putting the wallet into the backpack to make room)
Taken.
loaf of bread: (putting the dwarf banana tree into the backpack to make room)
Taken.
piece of cheese: (putting the frying pan into the backpack to make room)
Taken.
steak: (putting the loaf of bread into the backpack to make room)
Taken.
glass bottle: (putting the piece of cheese into the backpack to make room)
Taken.
Dankdrinke: The glass bottle isn't open.
bedsheets: (putting the steak into the backpack to make room)
Taken.
pair of Central European panties: (putting the glass bottle into the backpack to make room)
Nice.

>drop pan
You haven't got that.

>i
You are carrying:
  a pair of Central European panties
  bedsheets
  a backpack (open)
    a glass bottle (closed)
      some Dankdrinke
    a steak
    a piece of cheese
    a loaf of bread
    a frying pan
    a dwarf banana tree
    a wallet
      5 kroner
      1 Uncle Sam

>i
You are carrying:
  a pair of Central European panties
  bedsheets
  a backpack (open)
    a glass bottle (closed)
      some Dankdrinke
    a steak
    a piece of cheese
    a loaf of bread
    a frying pan
    a dwarf banana tree
    a wallet
      5 kroner
      1 Uncle Sam

>cook steak
You cook the steak, filling the Apartment with delicious smells.

[Your score has just gone up by one point.]

>cook bread
You cook the loaf of bread, filling the Apartment with tasty smells.

>cook tree
You cook the dwarf banana tree, filling the Apartment with mouth-watering smells.

>cook bottle
You cook the glass bottle, filling the Apartment with delectable smells.

>cook wallete
You can't see any such thing.

>cook wallet
You cook the wallet, filling the Apartment with tasty smells.

* * *

>take pack
You take the backpack.

>s
(first opening the apartment door)

Hellerup Strandvejen
The main street of Hellerup is bordered on its north side by brightly-painted row houses, such as the one containing your apartment. At the east end is a dock, and if you go west you can catch a train.

You can see an apartment door, a street vendor and a wheelbarrow (in which are a pile of herring and a mound of herring) here.

>buy herring. buy herring.
Which do you mean, the fistful of herring, the pile of herring or the mound of herring?

>pile
You pay 1 kroner for the pile of herring, leaving yourself with 4 kroner.

(the pile of herring)
That doesn't cost any money.
You already have that.

>buy moud
You can't see any such thing.

>buy mound
You pay 2 kroner for the mound of herring, leaving yourself with 2 kroner.

>test bird-a
(Testing.)

>[1] e

Dock
This is a shabby little dock used for the fishing trade. At the end of the dock, a little rowboat, moored with a rope, bobs up and down. In the rowboat is a large crate, atop which sits a bird.

>[2] feed pile to bird
The wretched bird regards you warily, then opens its beak and snaps up the pile of herring. It swallows in one gulp.

You see a flash of brilliance in its black, beady eyes. Then it caws, and flies off in the direction of Copenhagen.

You feel strangely proud.

[Your score has just gone up by one point.]

>gonear wretched bir
I only understood you as far as wanting to gonear the wretched bird.

>gonear wretched bird
*** Run-time problem P61: Attempt to move the player off-stage.

>restart
Are you sure you want to restart?

* * *

>purloin steak
[Purloined.]

>purloin pile
[Purloined.]

>purloin mound
[Purloined.]

>gonear wretched
Dock
This is a shabby little dock used for the fishing trade. At the end of the dock, a little rowboat, moored with a rope, bobs up and down. In the rowboat is a large crate, atop which sits a bird.

>feed sam to wretched
(first taking 1 Uncle Sam)
You're carrying too many things already.

>i
You are carrying:
  a mound of herring
  a pile of herring
  a steak
  a wallet
    5 kroner
    1 Uncle Sam

>purloin pack
[Purloined.]

>feed sam to wretched
(first taking 1 Uncle Sam)
(putting the wallet into the backpack to make room)
You're carrying too many things already.

>drop all
backpack: Dropped.
mound of herring: Dropped.
pile of herring: Dropped.
steak: Dropped.

>take sam
Taken.

>feed sam to wretched
The wretched bird is too lowly for you to feed it 1 Uncle Sam.

>feed steak to wretched
(first taking the steak)
The wretched bird is too lowly for you to feed it the steak.

* * *

>take pack
You take the backpack.

>take ackpack
You can't see any such thing.

>g backpack
You can't see any such thing.

>get backpack
Taken.

>g
You already have that.

>x
(the backpack)
Adorned with the seal of Reed College, your undergraduate alma mater.

>take pan
Taken.

>take bread
Taken.

>x fridge
Silver, yet subtle.

>open fridge
You open the fridge, revealing a piece of cheese, a steak and a glass bottle.

>close fridge
You close the fridge.

>pull handle
You open the fridge, revealing a piece of cheese, a steak and a glass bottle.

>x handle
Quite affordant.

* * *

>take pack
You take the backpack.

>test apt
(Testing.)

>[1] x fridge
Silver, yet subtle. The handle is quite affordant..

>[2] open fridge
You open the fridge, revealing a piece of cheese, a steak and a glass bottle.

>[3] x bottle
It contains some Dankdrinke.

In the glass bottle is some Dankdrinke.

>[4] open bottle
You open the glass bottle.

>[5] x dankdrinke
No drinke is more ergonomik than Dankdrinke!

>[6] drink dankdrinke
(first taking the Dankdrinke)
Your throat is filled with ergonomitivity.

[Your score has just gone up by one point.]

>[7] x sheets
Extremely rumpled from excessive romping.

>[8] x panties
Pink and frilly. You should probably return those.

>[9] x rug
The rug depicts a scene of universal healthcare flying over a lake.

>[10] take panties
Nice.

>[11] take banana tree
(putting the wallet into the backpack to make room)

>s
(first opening the apartment door)

Hellerup Strandvejen
The main street of Hellerup is bordered on its north side by brightly-painted row houses, such as the one containing your apartment. At the east end is a dock, and if you go west you can catch a train.

You can see an apartment door, a street vendor and a wheelbarrow (in which are a pile of herring and a mound of herring) here.

I beg your pardon?

>r
Time passes.

The vendor calls out, "pile of herring and mound of herring! Fresh!"

* * *

>take pack
You take the backpack.

>test fridge
>--> The following tests are available:
'test bungo'
'test pack'
'test apt'
'test leave'
'test vendor'
'test bird-a'
'test docktoplatform'
'test uptodock'
'test wait-a'
'test trainto'
'test uptocope'
'test ana'
'test butt'
'test inside-tree'

>test apt
(Testing.)

>[1] x fridge
Silver, yet subtle. The handle is quite affordant.

>[2] open fridge
You open the fridge, revealing a piece of cheese, a steak and a glass bottle of Dankdrinke.

>[3] x bottle
You see nothing special about the glass bottle of Dankdrinke.

>[4] open bottle
>[5] x dankdrinke
The glass bottle of Dankdrinke is empty.

>[6] drink dankdrinke
(first taking the glass bottle of Dankdrinke)
You take the glass bottle of Dankdrinke.

Your throat is filled with ergonomitivity.

[Your score has just gone up by one point.]

>[7] x sheets
Extremely rumpled from excessive romping.

>[8] x panties
Pink, frilly, and definitely not yours.

>[9] x rug
The rug depicts a scene of universal healthcare flying over a lake.

>[10] take panties
Nice.

>[11] take banana tree
(putting the wallet into the backpack to make room)
You take the dwarf banana tree.

* * *

>take pak
You can't see any such thing.

>take pack
Taken.

>take bread
Taken.

>take tree
(putting the wallet into the backpack to make room)

>s
(first opening the apartment door)

Hellerup Strandvejen
The main street of Hellerup is bordered on its north side by brightly-painted row houses, such as the one containing your apartment. At the east end is a dock, and if you go west you can catch a train.

You can see an apartment door, a street vendor and a wheelbarrow (in which are a pile of herring and a mound of herring) here.

>give steak to vendor
You can't see any such thing.

>give steak to street vendor
You can't see any such thing.

>purloin flower. purloin floer.
[Purloined.]

There seems to be no such object anywhere in the model world.

>purloin flower. purloin flower.
[Purloined.]

[Purloined.]

>gonear bench
IIT Campus
The campus is pretty sleepy in the summer. A construction crew works below the bell tower, but the only student you see is Ana.

You can see Ana and a stone bench here.

>x ana
A Czech girl. Starting next week, she's your TA for Introductory Programming. Starting last night, she's your lover.

>talk ana
That's not a verb I recognize.

>talk to ana
That's not a verb I recognize.

>suck ana
That's not a verb I recognize.

>give ana flower
Ana sighs and kisses your cheek. She strolls over to the bench, and sits down to gaze at the flower.

[Your score has just gone up by one point.]

>give flower to ana
(first taking the flower)
That seems to belong to Ana.

>i
You are carrying:
  a dwarf banana tree
  a loaf of bread
  a backpack (open)
    a wallet
      5 kroner
      1 Uncle Sam

>ana
That's not a verb I recognize.

>x ana
A Czech girl. Starting next week, she's your TA for Introductory Programming. Starting last night, she's your lover.

>give ana
What do you want to give Ana?

>flower
(first taking the flower)
That seems to belong to Ana.

>i
You are carrying:
  a dwarf banana tree
  a loaf of bread
  a backpack (open)
    a wallet
      5 kroner
      1 Uncle Sam

* * *

>take panties
Taken.

* * *

>take steak
You can't see any such thing.

>test pack / test apt
I only understood you as far as wanting to test that.

>test pack
(Testing.)

>[1] get pack
Taken.

>test apt
(Testing.)

>[1] x fridge
Silver, yet subtle. The handle is quite affordant..

>[2] open fridge
You open the fridge, revealing a piece of cheese, a steak and a glass bottle.

>[3] x bottle
It contains some Dankdrinke.

In the glass bottle is some Dankdrinke.

>[4] open bottle
You open the glass bottle.

>[5] x dankdrinke
No drinke is more ergonomik than Dankdrinke!

>[6] drink dankdrinke
(first taking the Dankdrinke)
Your throat is filled with ergonomitivity.

[Your score has just gone up by one point.]

>[7] x sheets
Extremely rumpled from excessive romping.

>[8] x panties
Pink and frilly. They belong to a girl named Ana.

>[9] x rug
The rug depicts a scene of universal healthcare flying over a lake.

>[10] take panties
Nice.

>[11] take banana tree
(putting the wallet into the backpack to make room)

I beg your pardon?

>s
(first opening the apartment door)

Hellerup Strandvejen
The main street of Hellerup is bordered on its north side by brightly-painted row houses, such as the one containing your apartment. At the east end is a dock, and if you go west you can catch a train.

You can see an apartment door, a street vendor and a wheelbarrow (in which are a pile of herring and a mound of herring) here.

>buy pile
You pay 1 kroner for the pile of herring, leaving yourself with 4 kroner.

>w
Train Platform
The open-air train platform has a line that runs to Copenhagen every 10 minutes. There are no tickets: it is free to ride.

You can see a paper kroner here.

* * *

I beg your pardon?

>e
Dock
This is a shabby little dock used for the fishing trade. At the end of the dock, a little rowboat, moored with a rope, bobs up and down. In the rowboat is a large crate, atop which sits a bird.

>give herring to bird
(the pile of herring to the wretched bird)
The wretched bird does not desire a pile of herring.

* * *

>take steak, tree.
You can't see any such thing.

>take steak. take tree.
You can't see any such thing.

>take steak
You can't see any such thing.

* * *

>take steak
You can't see any such thing.

>open fridge
You open the fridge, revealing a piece of cheese, a steak and a glass bottle.

>take steak
Taken.

>take drinke
You can't see any such thing.

>take dank
You can't see any such thing.

>take dankdrinke
The glass bottle isn't open.

>take bottle
You're carrying too many things already.

* * *

>test
>--> The following tests are available:
'test me'

>test me
(Testing.)

>[1] x fridge
The handle is quite affordant.

>[2] open fridge
You open the fridge, revealing a piece of cheese, a steak and a glass bottle.

>[3] x bottle
In the glass bottle is some Dankdrinke.

>[4] open bottle
You open the glass bottle.

>[5] x dankdrinke
No drinke is more ergönomik than Dankdrinke!

>[6] drink dankdrinke
(first taking the Dankdrinke)
You eat the Dankdrinke. Not bad.

* * *

>test apt
(Testing.)

>[1] x fridge
Silver, yet subtle. The handle is quite affordant.

>[2] open fridge
You open the fridge, revealing a piece of cheese, a steak and a glass bottle of Dankdrinke.

>[3] x bottle
No drinke is more ergonomik than Dankdrinke!

>[4] x dankdrinke
No drinke is more ergonomik than Dankdrinke!

>[5] drink dankdrinke
(first taking the glass bottle of Dankdrinke)
Your throat is filled with ergonomitivity.

[Your score has just gone up by one point.]

>[6] x sheets
Extremely rumpled from excessive romping.

>[7] x panties
Pink, frilly, and definitely not yours.

>[8] x rug
The rug depicts a scene of universal healthcare flying over a lake.

>[9] take panties
Nice.

>[10] take banana tree
Taken.

>drop
What do you want to drop?

>dro all
You can't see any such thing.

>drop all
pair of Central European panties: Dropped.
glass bottle: Dropped.
wallet: Dropped.

>take pack
You take the backpack.

>take all
wallet: You take the wallet.
glass bottle: You take the glass bottle.
pair of Central European panties: (putting the wallet into the backpack to make room)
You take the pair of Central European panties.
dwarf banana tree: (putting the glass bottle into the backpack to make room)
You take the dwarf banana tree.
5 kroner: No need to do anything with that until you want to buy something.
1 Uncle Sam: (putting the pair of Central European panties into the backpack to make room)
You take 1 Uncle Sam.
Dankdrinke: (putting the dwarf banana tree into the backpack to make room)
You take the glass bottle.
frying pan: (putting 1 Uncle Sam into the backpack to make room)
You take the frying pan.
loaf of bread: (putting the glass bottle into the backpack to make room)
You take the loaf of bread.
piece of cheese: (putting the frying pan into the backpack to make room)
You take the piece of cheese.
steak: (putting the loaf of bread into the backpack to make room)
You take the steak.
bedsheets: (putting the piece of cheese into the backpack to make room)
You take bedsheets.

>s
(first opening the apartment door)

Hellerup Strandvejen
The main street of Hellerup is bordered on its north side by brightly-painted row houses, such as the one containing your apartment. At the east end is a dock, and if you go west you can catch a train.

You can see an apartment door, a street vendor and a wheelbarrow (in which are a pile of herring and a mound of herring) here.

>drink bottle
(first taking the Dankdrinke)
(putting the steak into the backpack to make room)
You take the glass bottle.

>drink bottle
(first taking the Dankdrinke)
You already have that.

The vendor calls out, "Today I have a pile of herring and a mound of herring! Fresh!"

>drink bottle
(first taking the Dankdrinke)
You already have that.

The vendor calls out, "Today I have a pile of herring and a mound of herring! Fresh!"

>drink dankdrinke
(first taking the Dankdrinke)
You already have that.

>eat dankdrinke
(first taking the Dankdrinke)
You already have that.

>open bottle
That's already open.

The vendor calls out, "Today I have a pile of herring and a mound of herring! Fresh!"

>take dandrinke
You can't see any such thing.

>i
You are carrying:
  a glass bottle (open)
    some Dankdrinke
  bedsheets
  a backpack (open)
    a steak
    a piece of cheese
    a loaf of bread
    a frying pan
    1 Uncle Sam
    a dwarf banana tree
    a pair of Central European panties
    a wallet
      5 kroner

>l
Hellerup Strandvejen
The main street of Hellerup is bordered on its north side by brightly-painted row houses, such as the one containing your apartment. At the east end is a dock, and if you go west you can catch a train.

You can see an apartment door, a street vendor and a wheelbarrow (in which are a pile of herring and a mound of herring) here.

>l bottle
It contains some Dankdrinke.

In the glass bottle is some Dankdrinke.

>eat dankdrinke
(first taking the Dankdrinke)
You already have that.

The vendor calls out, "Today I have a pile of herring and a mound of herring! Fresh!"

>drop dankdrinke
You haven't got that.

>drop bottle
Dropped.

>take bottle
You take the glass bottle.

>drink it
(first taking the Dankdrinke)
You already have that.

>drop all
glass bottle: Dropped.
bedsheets: Dropped.
backpack: Dropped.

The vendor calls out, "Today I have a pile of herring and a mound of herring! Fresh!"

>drink botte
You can't see any such thing.

>drink bottle
(first taking the Dankdrinke)
You take the glass bottle.

The vendor calls out, "Today I have a pile of herring and a mound of herring! Fresh!"

>open bottle
That's already open.

>drink dankdrinke
(first taking the Dankdrinke)
You already have that.

>restart
Are you sure you want to restart?

* * *

>take pack. take all
You take the backpack.

dwarf banana tree: You take the dwarf banana tree.
frying pan: (putting the wallet into the backpack to make room)
You take the frying pan.
loaf of bread: (putting the dwarf banana tree into the backpack to make room)
You take the loaf of bread.
bedsheets: (putting the frying pan into the backpack to make room)
You take bedsheets.
pair of Central European panties: (putting the loaf of bread into the backpack to make room)
Nice.

>open fridge
You open the fridge, revealing a piece of cheese, a steak and a glass bottle.

>take al
You can't see any such thing.

>take all
piece of cheese: (putting bedsheets into the backpack to make room)
You take the piece of cheese.
steak: (putting the pair of Central European panties into the backpack to make room)
You take the steak.
glass bottle: (putting the piece of cheese into the backpack to make room)
You take the glass bottle.
Dankdrinke: The glass bottle isn't open.

>drink bottle
You open the glass bottle.

(first taking the Dankdrinke)
You already have that.

>open it
That's already open.

* * *

>drop all
dwarf banana tree: Dropped.
pair of Central European panties: Dropped.
wallet: Dropped.

>take pack
Taken.

>take steak
Taken.

>eat steak
That's definitely not edible.

* * *

>s
(first opening the apartment door)
You can't go to school without your backpack.

>take pack
You're carrying too many things already.

>s
(first opening the apartment door)
You can't go to school without your backpack.

* * *

>drop tree
Dropped.

>take pack
Taken.

>take tree
(putting the wallet into the backpack to make room)

* * *

>s
(first opening the apartment door)

Hellerup Strandvejen
The main street of Hellerup is bordered on its north side by brightly-painted row houses, such as the one containing your apartment. At the east end is a dock, and if you go west you can catch a train.

You can see an apartment door, a street vendor and a wheelbarrow (in which are a pile of herring and a mound of herring) here.

>r
Time passes.

The vendor scratches his nose.

>r
Time passes.

>r
Time passes.

The vendor adjusts his pants.

>r
Time passes.

>r
Time passes.

The vendor scratches his nose.

* * *

>r
Time passes.

>r
Time passes.

The vendor tips his hat.

>r
Time passes.

* * *

>take pack
You're carrying too many things already.

>drop tree
Dropped.

* * *

>take pack
Taken.

>s
(first opening the apartment door)

Hellerup Strandvejen
The main street of Hellerup is bordered on its north side by brightly-painted row houses, such as the one containing your apartment. At the east end is a dock, and if you go west you can catch a train.

You can see an apartment door, a street vendor and a wheelbarrow (in which are a pile of herring and a mound of herring) here.

The vendor calls out, "a pile of herring and a mound of herring! Fresh!"

* * *

>test leave
(Testing.)

>[1] test apt
(Testing.)

>[2] x fridge
The handle is quite affordant. No magnets or other blemishes mar the subtle sheen of the silver fridge face.

In the fridge are a piece of cheese, a steak and a glass bottle.

>[3] open fridge
That's already open.

>[4] x bottle
The glass bottle is empty.

>[5] open bottle
That's already open.

>[6] x dankdrinke
You can't see any such thing.

>[7] drink dankdrinke
You can't see any such thing.

>[8] go south
(first opening the apartment door)

Hellerup Main Street
You can see a Street Vendor here.

* * *

>test pack
(Testing.)

>[1] get pack
Taken.

>s
(first opening the apartment door)

Hellerup Strandvejen
The main street of Hellerup is bordered on its north side by brightly-painted row houses, such as the one containing your apartment. At the east end is a dock, and if you go west you can catch a train.

You can see an apartment door, a street vendor and a wheelbarrow (in which are a pile of herring and a mound of herring) here.

The vendor eyes your pair of Central European panties.

>take vendor
You can't take a person!

The vendor eyes your wallet.

>n
Apartment
Your apartment is a cheery little box. On the east wall is a round window. A woven rug adorns the floor in the middle of the room. Along the west wall are a fridge and some shelves. A bed lies in the northwest corner, and a stove lies in the northeast.

On the stove is a frying pan.

On the shelves is a loaf of bread.

You can also see an apartment door, a dwarf banana tree, a fridge (in which are a piece of cheese, a steak and a glass bottle (empty)) and the bed (on which is bedsheets) here.

* * *

>r
Time passes.

>r
Time passes.

The C-Train departs without you.

>l
Train Platform
The open-air train platform has a line that runs to Copenhagen every 10 minutes. There are no tickets: just line up and wait for the next train to come.

>r
Time passes.

>r / r /r
I only understood you as far as wanting to r.

>r / r / r
I only understood you as far as wanting to r.

>r. r. r.
Time passes.

The C-Train arrives.

Time passes.

Time passes.

>enter
You get into the C-Train.

>r . r .
Time passes.

Time passes.

The C-Train departs, taking you into a tunnel.

>r.r.r.
Time passes.

Time passes.

Time passes.

>r.
Time passes.

>r.
Time passes.

You arrive in Copenhagen.

>exit
Copenhagen Metro Station
This is the main metro station in Copenhagen. Its creator won the Best Dane of the Year Award.

Stairs lead southward and upward to the IIT Campus exit. Christiana is northwest of here: this much you know.

The Danes are very efficient: you can also take a direct route west from here to the Aarenhus Cemetery.

A small door stands in the southeast corner of the station near a fake tree.

You can see a C-Train (empty) here.

>n
You can't go that way.

>s
IIT Campus
The campus is pretty sleepy in the summer. A construction crew works below the bell tower, but the only student you see is Ana.

You can see Ana here.

>take ana
You can't take a person!

>give panties to Ana
She blushes, snatches the pair of Central European panties, and storms off.

[Your score has just gone up by one point.]

I beg your pardon?

>l
IIT Campus
The campus is pretty sleepy in the summer. A construction crew works below the bell tower, but the only student you see is Ana.

You can see Ana here.

>take ana
You can't take a person!

>x ana
A Czech girl. Starting next week, she's your TA for Introductory Programming. Starting last night, she's your lover.

* * *

>test bird
(Testing.)

>[1] test apt
(Testing.)

>[2] x fridge
Silver, yet subtle. The handle is quite affordant..

>[3] open fridge
You open the fridge, revealing a piece of cheese, a steak and a glass bottle.

>[4] x bottle
It contains some Dankdrinke.

In the glass bottle is some Dankdrinke.

>[5] open bottle
You open the glass bottle.

>[6] x dankdrinke
No drinke is more ergonomik than Dankdrinke!

>[7] drink dankdrinke
(first taking the Dankdrinke)
Your throat is filled with ergonomitivity.

[Your score has just gone up by one point.]

>[8] x sheets
Extremely rumpled from excessive romping.

>[9] x panties
Pink and frilly. You should probably return those.

>[10] x rug
The rug depicts a scene of universal healthcare flying over a lake.

>[11] take panties
Nice.

[Your score has just gone up by one point.]

>[12] take steak
Taken.

>[13] test leave
(Testing.)

>[14] get pack
Taken.

>[15] go south
(first opening the apartment door)

Hellerup Strandvejen
The main street of Hellerup is bordered on its north side by brightly-painted row houses, such as the one containing your apartment. At the east end is a dock, and if you go west you can catch a train.

You can see a street vendor and a wheelbarrow (in which are a pile of herring and a mound of herring) here.

The vendor eyes your backpack.

>[16] buy pile of herring
You pay 1 kroner for the pile of herring, leaving yourself with 4 kroner.

The vendor eyes your wallet.

>[17] feed herring to vendor
(the pile of herring to the street vendor)
The street vendor is not willing to be fed by you.

The vendor eyes your steak.

>[18] east

Dock
This is a shabby little dock used for the fishing trade. At the end of the dock, a little rowboat, moored with a rope, bobs up and down. In the rowboat is a large crate, atop which sits a bird.

>[19] look
Dock
This is a shabby little dock used for the fishing trade. At the end of the dock, a little rowboat, moored with a rope, bobs up and down. In the rowboat is a large crate, atop which sits a bird.

>[20] feed panties to bird
Unlike you, the wretched bird is entirely unmotivated by sexy underwear.

>[21] feed herring to bird
(the pile of herring to the wretched bird)
The bird regards you warily, then opens its beak and snaps up the pile of herring. It swallows in one gulp.

You see a flash of brilliance in its black, beady eyes. Then it caws, and flies off in the direction of Copenhagen.

You feel strangely proud.

[Your score has just gone up by two points.]

>restart
Are you sure you want to restart?

Please answer yes or no.

>y
It is the Year of Our Lord MMXVIII. You have arrived in the Danish city of Copenhagen to pursue a master's degree. You found an apartment for let in the suburb of Hellerup, and promptly moved in. The place isn't much, but for the next two years it's home. 

PREPARE YOUR SPIRIT FOR . . .

RYAN QUEST 2
An Interactive Fiction by Maxwell Joslyn
Release 1 / Serial number 181116 / Inform 7 build 6M62 (I6/v6.33 lib 6/12N) SD

Apartment
Your apartment is a cheery little box. On the east wall is a round window. A woven rug adorns the floor in the middle of the room. Along the west wall are a fridge and some shelves. A bed lies in the northwest corner, and a stove lies in the northeast.

On the stove is a frying pan.

On the shelves is a loaf of bread.

You can also see a backpack (empty), a dwarf banana tree, a fridge (closed) and the bed (on which are bedsheets and a pair of Central European panties) here.

>test metro
(Testing.)

>[1] test train
(Testing.)

>[2] test apt
(Testing.)

>[3] x fridge
Silver, yet subtle. The handle is quite affordant..

>[4] open fridge
You open the fridge, revealing a piece of cheese, a steak and a glass bottle.

>[5] x bottle
It contains some Dankdrinke.

In the glass bottle is some Dankdrinke.

>[6] open bottle
You open the glass bottle.

>[7] x dankdrinke
No drinke is more ergonomik than Dankdrinke!

>[8] drink dankdrinke
(first taking the Dankdrinke)
Your throat is filled with ergonomitivity.

[Your score has just gone up by one point.]

>[9] x sheets
Extremely rumpled from excessive romping.

>[10] x panties
Pink and frilly. You should probably return those.

>[11] x rug
The rug depicts a scene of universal healthcare flying over a lake.

>[12] take panties
Nice.

[Your score has just gone up by one point.]

>[13] test leave
(Testing.)

>[14] get pack
Taken.

>[15] go south
(first opening the apartment door)

Hellerup Strandvejen
The main street of Hellerup is bordered on its north side by brightly-painted row houses, such as the one containing your apartment. At the east end is a dock, and if you go west you can catch a train.

You can see a street vendor and a wheelbarrow (in which are a pile of herring and a mound of herring) here.

The vendor eyes your pair of Central European panties.

>[16] w

Train Platform
The open-air train platform has a line that runs to Copenhagen every 10 minutes. There are no tickets: just line up and wait for the next train to come.

You can see a paper kroner here.

>[17] w
You can't go that way.

>[18] wait
Time passes.

>[19] wait
Time passes.

>[20] wait
Time passes.

>[21] wait
Time passes.

>[22] wait
Time passes.

>[23] wait
Time passes.

>[24] wait
Time passes.

>[25] wait
Time passes.

>[26] wait
Time passes.

>[27] wait
Time passes.

>[28] wait
Time passes.

The C-Train arrives.

>[29] enter train
You get into the C-Train.

>[30] wait
Time passes.

>[31] wait
Time passes.

>[32] wait
Time passes.

>[33] wait
Time passes.

The C-Train departs, taking you into a tunnel.

>[34] wait
Time passes.

>[35] wait
Time passes.

>[36] wait
Time passes.

>[37] wait
Time passes.

>[38] wait
Time passes.

You arrive in Copenhagen.

>[39] wait
Time passes.

>[40] exit
Copenhagen Metro Station
This is the main metro station in Copenhagen. Its creator won the Best Dane of the Year Award.

Stairs lead southward and upward to the IIT Campus exit. Christiana is northwest of here. The Aarenhus Cemetery is west of here.

A small, unmarked door stands in the southeast corner of the station.

You can see a C-Train (empty) here.

* * *

>test bungo
(Testing.)

>[1] purloin steak
[Purloined.]

>[2] purloin flower
Which do you mean, the red flower, the white flower, the blue flower or the yellow flower?

>[3] gonear ana
IIT Campus
The campus is pretty sleepy in the summer. A construction crew works below the bell tower, but the only student you see is Ana.

You can see Ana and a stone bench here.

>[4] give steak to ana
She slaps the steak out of your hand.

>[5] touch ana
She slaps your hand away.

>[6] kiss ana
She slaps the kiss right off your lips.

>[7] give flower to ana
You can't see any such thing.

>[8] touch ana
She slaps your hand away.

>[9] kiss ana
She slaps the kiss right off your lips.

I beg your pardon?

>enter bench
You get onto the stone bench.

On the stone bench you can see Ana.

>sit on bench
But you're already on the stone bench.

>x ana
A Czech girl. Starting next week, she's your TA for Introductory Programming. Starting last night, she's your lover.

>i ana
I only understood you as far as wanting to take inventory.

>l ana
A Czech girl. Starting next week, she's your TA for Introductory Programming. Starting last night, she's your lover.

* * *

>enter bench
You get into the stone bench.

In the stone bench you can see Ana.

* * *

>i
You are carrying:
  a wallet
    5 kroner
    1 Uncle Sam

>give ana uncle sam
She slaps 1 Uncle Sam out of your hand.

* * *

>purloin red
[Purloined.]

>give red to ana
Ana sighs and kisses your cheek. She strolls over to the bench, and sits down to gaze at the flower.

[Your score has just gone up by one point.]

>touch ana
You caress her, and she rubs her head against your hand.

>give panties to ana
You can't see any such thing.

>purloin panties
[Purloined.]

>give panties to ana
She blushes deeply, then stuffs the pair of Central European panties into her pocket. "Thank you," she says softly.

[Your score has just gone up by one point.]

>purloin all flowers
(the red flower)
[Purloined.]

>purloin yellow
[Purloined.]

>purloin blue
[Purloined.]

>purloin white
[Purloined.]

>give flower to ana
Which do you mean, the white flower, the blue flower, the yellow flower or the red flower?

>red
Ana giggles.

>give white to ana
Ana grins.

>give blue to ana
Ana blushes.

>give yellow to ana
Ana tickles your hand.

>get on bench
There is no more room on the stone bench.

>x benh
You can't see any such thing.

>x bench
Effortlessly square.

On the base, nearly invisible, is an unlabelled beige button.

On the stone bench is Ana.

>push button
From somewhere nearby, a voice yells, "F!"

>g
From somewhere nearby, a voice yells, "E!"

* * *

>g
From somewhere nearby, a voice yells, "R!"

>g
From somewhere nearby, a voice yells, "D!"
[Your score has just gone up by one point.]

>g
Nothing appears to happen.

* * *

>test but
>--> The following tests are available:
'test bungo'
'test pack'
'test apt'
'test leave'
'test vendor'
'test bird-a'
'test docktoplatform'
'test uptodock'
'test wait-a'
'test trainto'
'test uptocope'
'test ana'
'test butt'
'test inside-tree'

>test butt
(Testing.)

>[1] gonear button
IIT Campus
The campus is pretty sleepy in the summer. A construction crew works below the bell tower, but the only student you see is Ana.

You can see Ana and a stone bench here.

>[2] press button
A voice yells, 'F!'
>[3] g
A voice yells, 'E!'
>[4] g
A voice yells, 'E!'
>[5] g
A voice yells, 'D!'
>[6] g
A voice yells, 'B!'
>[7] g
A voice yells, 'I!'
>[8] g
A voice yells, 'R!'
>[9] g
A voice yells, 'D!'
>[10] g
>[11] g
>[12] g

* * *

>test butt
(Testing.)

>[1] gonear button
IIT Campus
The campus is pretty sleepy in the summer. A construction crew works below the bell tower, but the only student you see is Ana.

You can see Ana and a stone bench here.

>[2] press button
From somewhere nearby, a voice yells, "F!"
>[3] g
From somewhere nearby, a voice yells, "E!"
>[4] g
From somewhere nearby, a voice yells, "E!"
>[5] g
From somewhere nearby, a voice yells, "D!"
>[6] g
From somewhere nearby, a voice yells, "B!"
>[7] g
From somewhere nearby, a voice yells, "I!"
>[8] g
From somewhere nearby, a voice yells, "R!"
>[9] g
From somewhere nearby, a voice yells, "D!"
>[10] g
Nothing appears to happen.
;-)
[Your score has just gone up by one point.]

>g
Nothing appears to happen.
;-)
[Your score has just gone up by one point.]

>touch ana
She slaps your hand away.

>gonear pusher
Christiana Main Street
This street is lined with drug pushers, filled with tourists, dotted with hippies, and sprinkled with musicians.

You can see a pusher and a pushcart (on which is a marijuana joint) here.

The pusher eyes your wallet.

>touch pusher
The pusher might not like that.

The pusher eyes your wallet.

>press pusher
Mind your manners, American!

The pusher eyes your wallet.

* * *

>test cembird
(first moving to Aarenhus Cemetery)

(first acquiring the pile of herring)
(Testing.)

>[1] feed herring to bird
You can't see any such thing.

* * *

>test comm
(Testing.)

>[1] gonear platform
Train Platform
The open-air train platform has a line that runs to Copenhagen every 10 minutes. There are no tickets: it is free to ride.

In the northwest corner of the station stands the staircase that leads to the Commissary.

You can see a wall sign, a paper krone and an arrow-shaped sign here.

The C-Train arrives.

>[2] down

Socialist Money Commissary
The inside of the commissary is a bit cramped, but the lighting is gentle and there is air-conditioning. 

You can see a clerk, a one-krone note, a two-kroner note and a three-kroner note here.

>[3] x clerk
She gives you the smile of a true believer. She is wearing a brown jumpsuit and a gold apron.

>[4] x one-krone
Depicts some silly old king.

It costs 1 kroner.

>[5] x two-kroner note
Depicts Queen Magrethe.

It costs 2 kroner.

>[6] x three-kroner note
Depicts Jonathan Blow.

It costs 3 kroner.

>[7] take one-krone
Foolish American! Under Socialism, everyone has a job to do - and the clerk's job is to hand you that one-krone note. For free!

The clerk picks up the one-krone note.

The clerk gives the one-krone note to you.

>[8] ask clerk for two-kroner
The clerk does as you ask.

The clerk picks up the two-kroner note.

The clerk gives the two-kroner note to you.

>ask clerk for two-krone note
(the clerk first taking the two-kroner note)
The clerk has better things to do.

>ask clerk for note
Which do you mean, the two-kroner note or the three-kroner note?

>three-kroner note
(the clerk first taking the three-kroner note)
The clerk has better things to do.

>ask clerk for three-kroner note
(the clerk first taking the three-kroner note)
The clerk has better things to do.

>i
You are carrying:
  a wallet
    6 kroner
    1 Uncle Sam

>ask clerk to give note
I didn't understand that sentence.

>ask clerk for note
Which do you mean, the two-kroner note or the three-kroner note?

>three-kroner
(the clerk first taking the three-kroner note)
The clerk has better things to do.

>i
You are carrying:
  a wallet
    6 kroner
    1 Uncle Sam

>l
Socialist Money Commissary
The inside of the commissary is a bit cramped, but the lighting is gentle and there is air-conditioning. 

You can see a clerk, a two-kroner note and a three-kroner note here.

>x clerk
She gives you the smile of a true believer. She is wearing a brown jumpsuit and a gold apron.

* * *

>clerk, give me two-kroner note
There is no reply.

>clerk, give me the note
(the clerk first taking the three-kroner note)
The clerk has better things to do.

* * *

>i
You are carrying:
  a wallet
    6 kroner
    1 Uncle Sam

* * *

>l
Socialist Money Commissary
The inside of the commissary is a bit cramped, but the lighting is gentle and there is air-conditioning. 

You can see a clerk and a three-kroner note here.

>take three-kroner
Stupid American! Under Socialism, everyone has a job to do - and the clerk's job is to hand you that three-kroner note. For free!

The clerk picks up the three-kroner note.

The clerk gives the three-kroner note to you.

>l
Socialist Money Commissary
The inside of the commissary is a bit cramped, but the lighting is gentle and there is air-conditioning. 

You can see a three-kroner note and a clerk here.

>l
Socialist Money Commissary
The inside of the commissary is a bit cramped, but the lighting is gentle and there is air-conditioning. 

You can see a three-kroner note and a clerk here.

>i
You are carrying:
  a wallet
    11 kroner
    1 Uncle Sam

>take three-kroner
Idiotic American! Under Socialism, everyone has a job to do - and the clerk's job is to hand you that three-kroner note. For free!

The clerk picks up the three-kroner note.

The clerk gives the three-kroner note to you.

>l
Socialist Money Commissary
The inside of the commissary is a bit cramped, but the lighting is gentle and there is air-conditioning. 

You can see a three-kroner note and a clerk here.

>i
You are carrying:
  a wallet
    14 kroner
    1 Uncle Sam

* * *

>take three
You can't see any such thing.

>take note
Stupid American! Under Socialism, everyone has a job to do - and the clerk's job is to hand you that three-kroner note. For free!

The clerk picks up the three-kroner note.

The clerk gives the three-kroner note to you.

FUCK they're out

>l
Socialist Money Commissary
The inside of the commissary is a bit cramped, but the lighting is gentle and there is air-conditioning. 

You can see a clerk here.

FUCK they're out

* * *

>take three-kroner
Stupid American! Under Socialism, everyone has a job to do - and the clerk's job is to hand you that three-kroner note. For free!

The clerk picks up the three-kroner note.

The clerk gives the three-kroner note to you.

Unfortunately, it seems they're all out of money for the day.

>l
Socialist Money Commissary
The inside of the commissary is a bit cramped, but the lighting is gentle and there is air-conditioning. 

You can see a clerk here.

Unfortunately, it seems they're all out of money for the day.

>x clerk
She gives you the smile of a true believer. She is wearing a brown jumpsuit and a gold apron.

Unfortunately, it seems they're all out of money for the day.

* * *

>test inside-tre
(Testing.)

>[1] purloin joint
[Purloined.]

>[2] gonear fake tree
Copenhagen Metro Station
This is the main metro station in Copenhagen. Its creator won the Best Dane of the Year Award.

Stairs lead southward and upward to the IIT Campus exit. Christiana is northwest of here: this much you know.

The Danes are very efficient: you can also take a direct route west from here to the Aarenhus Cemetery.

A small door stands in the southeast corner of the station near a fake tree.

>[3] smoke joint
You hit it and don't quit it. Your War-on-Drugs work ethic erases that joint from existence.

Now you're baked.

Wow. You're totally baked.

>[4] enter tree
You walk up to the fake tree. Your instincts propel you onward, and you walk into the tree.

You're inside the tree, Ryan.

Belly of the Tree
It's gloomy in here.

You're super baked.

I beg your pardon?

>i
You are carrying:
  a wallet
    5 kroner
    1 Uncle Sam

You're completely baked.

>l
Belly of the Tree
It's gloomy in here.

Damn. You're really, really baked.

>l
Belly of the Tree
It's gloomy in here.

You're super baked.

>l
Belly of the Tree
It's gloomy in here.

Man. You're totally baked.

>l
Belly of the Tree
It's gloomy in here.

You're super baked.

>l
Belly of the Tree
It's gloomy in here.

You're completely baked.

>exit
Copenhagen Metro Station
This is the main metro station in Copenhagen. Its creator won the Best Dane of the Year Award.

Stairs lead southward and upward to the IIT Campus exit. Christiana is northwest of here: this much you know.

The Danes are very efficient: you can also take a direct route west from here to the Aarenhus Cemetery.

A small door stands in the southeast corner of the station near a fake tree.

You can see a C-Train (in which is a wrap-around sofa) here.

Damn. You're totally baked.

>l
Copenhagen Metro Station
This is the main metro station in Copenhagen. Its creator won the Best Dane of the Year Award.

Stairs lead southward and upward to the IIT Campus exit. Christiana is northwest of here: this much you know.

The Danes are very efficient: you can also take a direct route west from here to the Aarenhus Cemetery.

A small door stands in the southeast corner of the station near a fake tree.

You can see a C-Train (in which is a wrap-around sofa) here.

You're super baked.

>w
Aarenhus Cemetery
Dark paths run here and there among the marble tombs. Some trees provide relaxing shade, and flowers bloom here and there.

You can see a red flower, a white flower, a blue flower and a yellow flower here.

You're totally baked.

* * *

>l
Darkness
It is pitch dark, and you can't see a thing.

You're, super and baked

>l
Darkness
It is pitch dark, and you can't see a thing.

You're, completely and baked

>l
Darkness
It is pitch dark, and you can't see a thing.

You're, completely and baked

>l
Darkness
It is pitch dark, and you can't see a thing.

You're, totally and baked

>l
Darkness
It is pitch dark, and you can't see a thing.

You're, totally and baked

>l
Darkness
It is pitch dark, and you can't see a thing.

You're, completely and baked

* * *

>test inside-tree
(Testing.)

>[1] purloin joint
[Purloined.]

>[2] gonear fake tree
Copenhagen Metro Station
This is the main metro station in Copenhagen. Its creator won the Best Dane of the Year Award.

Stairs lead southward and upward to the IIT Campus exit. Christiana is northwest of here: this much you know.

The Danes are very efficient: you can also take a direct route west from here to the Aarenhus Cemetery.

A small door stands in the southeast corner of the station near a fake tree.

You can see the fake tree here.

>[3] smoke joint
You hit it and don't quit it. Your War-on-Drugs work ethic erases that joint from existence.

Now you're baked.

Wow. You're totally baked.

>[4] enter tree
You walk up to the fake tree. Your instincts propel you onward, and you walk into the tree.

You're inside the tree, Ryan.

Belly of the Tree
It's gloomy in here.

You're super baked.

I beg your pardon?

* * *

>l
Darkness
It is pitch dark, and you can't see a thing.

>i
You are carrying:
  a wallet
    5 kroner
    1 Uncle Sam

* * *

I beg your pardon?

>i
You are carrying:
  a wallet
    5 kroner
    1 Uncle Sam

You'resuperbaked.

>l
Belly of the Tree
It's gloomy in here.

Wow.You'resuperbaked.

* * *

>exit
Copenhagen Metro Station
This is the main metro station in Copenhagen. Its creator won the Best Dane of the Year Award.

Stairs lead southward and upward to the IIT Campus exit. Christiana is northwest of here: this much you know.

The Danes are very efficient: you can also take a direct route west from here to the Aarenhus Cemetery.

A small door stands in the southeast corner of the station near a fake tree.

You're so baked!

>take tree
That's fixed in place.

* * *

>i
You are carrying:
  a wallet
    5 kroner
    1 Uncle Sam

Wow. You're completely baked.

* * *

>l
Belly of the Tree
It's gloomy in here.

Damn. You're completely baked.

>exit
You walk up to the fake tree. Your instincts propel you onward, and you walk into the tree.

Now you're inside the tree, Ryan.

Copenhagen Metro Station
This is the main metro station in Copenhagen. Its creator won the Best Dane of the Year Award.

Stairs lead southward and upward to the IIT Campus exit. Christiana is northwest of here: this much you know.

The Danes are very efficient: you can also take a direct route west from here to the Aarenhus Cemetery.

A small door stands in the southeast corner of the station near a fake tree.

You can see the fake tree here.

>l tree
A huge plastic palm tree which 'grows' from a wicker basket. It's fifteen feet tall and twenty feet around. Strangely, you feel like you can enter the tree!

* * *

>l
Belly of the Tree
It's gloomy in here.

Damn. You're completely baked.

>l
Belly of the Tree
It's gloomy in here.

You're really, really baked.

>l
Belly of the Tree
It's gloomy in here.

You're totally baked.

>l
Belly of the Tree
It's gloomy in here.

You're super baked.

* * *

>x tree
A plastic palm tree. It's huge: fifteen feet tall and twenty feet around. It 'grows' from an inch-thick disc of marble which is set into the floor of the station, disrupting hte pattern of tiles around it.

>l
Belly of the Tree
Did you really think your brain would figure this one out just by looking?

You can see the fake tree here.

* * *

>test into-tree
>--> The following tests are available:
'test bungo'
'test pack'
'test apt'
'test leave'
'test vendor'
'test bird-a'
'test docktoplatform'
'test uptodock'
'test wait-a'
'test trainto'
'test uptocope'
'test ana'
'test inside-tree'

>test inside-tree
(Testing.)

>[1] purloin joint
[Purloined.]

>[2] gonear fake tree
Copenhagen Metro Station
This is the main metro station in Copenhagen. Its creator won the Best Dane of the Year Award.

Stairs lead southward and upward to the IIT Campus exit. Christiana is northwest of here: this much you know.

The Danes are very efficient: you can also take a direct route west from here to the Aarenhus Cemetery.

A small door stands in the southeast corner of the station near a fake tree.

You can see the fake tree (closed) here.

>[3] smoke joint
You hit it and don't quit it. Your War-on-Drugs work ethic erases that joint from existence.

Now you're baked.

>[4] enter tree
You walk up to the fake tree. Your instincts propel you onward, and you walk into the tree.

Now you're inside the tree, Ryan.

Tree Zone
Did you really think your brain would figure this one out just by looking?

>l
Tree Zone
Did you really think your brain would figure this one out just by looking?

>exit
But you aren't in anything at the moment.

>leave
But you aren't in anything at the moment.

* * *

>test leave
(Testing.)

>[1] get pack
Taken.

>[2] go south
(first opening the apartment door)

Hellerup Strandvejen
The main street of Hellerup is bordered on its north side by brightly-painted row houses, such as the one containing your apartment. At the east end is a dock, and if you go west you can catch a train.

You can see a street vendor and a wheelbarrow (in which are a pile of herring and a mound of herring) here.

>[3] go east

Dock
This is a shabby little dock used for the fishing trade. At the end of the dock, a little rowboat, moored with a rope, bobs up and down.

>[4] look
Dock
This is a shabby little dock used for the fishing trade. At the end of the dock, a little rowboat, moored with a rope, bobs up and down.

>east
You can't go that way.

>west
Hellerup Strandvejen
The main street of Hellerup is bordered on its north side by brightly-painted row houses, such as the one containing your apartment. At the east end is a dock, and if you go west you can catch a train.

You can see a street vendor and a wheelbarrow (in which are a pile of herring and a mound of herring) here.

>west
Train Platform

* * *

>go dock
You can't see any such thing.

>east
Dock
This is a shabby little dock used for the fishing trade. At the end of the dock, a sad little rowboat, moored with a rope, bobs up and down.

* * *

>go east
You can't go that way.

>w
Hellerup Strandvejen
The main street of Hellerup is bordered on its north side by brightly-painted row houses, such as the one containing your apartment. At the east end is a dock, and if you go west you can catch a train.

You can see a street vendor and a wheelbarrow (in which are a pile of herring and a mound of herring) here.

>l
Hellerup Strandvejen
The main street of Hellerup is bordered on its north side by brightly-painted row houses, such as the one containing your apartment. At the east end is a dock, and if you go west you can catch a train.

You can see a street vendor and a wheelbarrow (in which are a pile of herring and a mound of herring) here.

>i
You are carrying:
  a backpack (open but empty)
  a wallet
    5 kroner
    1 Uncle Sam

>buy herring
Which do you mean, the fistful of herring, the pile of herring or the mound of herring?

* * *

>pile
You pay 1 kroner for the pile of herring, leaving yourself with 4 kroner.

>buy fistful
The fistful of herring doesn't cost any money.

That seems to belong to the street vendor.

* * *

>go east
You can't go that way.

>x rowboat
This crate is big, sturdy, weatherbeaten, and chained with a lock.

In the rowboat is the herring crate.

* * *

>w
Hellerup Strandvejen
The main street of Hellerup is bordered on its north side by brightly-painted row houses, such as the one containing your apartment. At the east end is a dock, and if you go west you can catch a train.

You can see a street vendor and a wheelbarrow (in which are a pile of herring and a mound of herring) here.

>w
Train Platform
Dong

>i
You are carrying:
  a backpack (open but empty)
  a wallet
    5 kroner

* * *

>test me
>--> The following tests are available:
'test bird'
'test apt'
'test leave'
'test train'
'test metro'
'test platform'

>r
That's not a verb I recognize.

* * *

>test mon
>--> The following tests are available:
'test bungo'
'test pack'
'test apt'
'test leave'
'test vendor'
'test bird-a'
'test docktoplatform'
'test uptodock'
'test wait-a'
'test trainto'
'test uptocope'
'test ana'
'test butt'
'test monk'
'test inside-tree'

>test monk
(Testing.)

>[1] gonear monk
Island of Technique
This little island is no tropical paradise. It's more like someone carved a chunk off of Scotland and dropped it at the edge of the bay. Foggy, muddy, and riddled with trees.

You can see a monk here.

>[2] ask monk for box
With much gravitas, the monk hands you the wooden box.

As you take it in your hands, you feel a great weightiness upon your soul.

The monk gives the wooden box to you.

[Your score has just gone up by one point.]

* * *

>test monk
(Testing.)

>[1] gonear monk
Island of Technique
This little island is no tropical paradise. It's more like someone carved a chunk off of Scotland and dropped it at the edge of the bay. Foggy, muddy, and riddled with trees.

You can see a monk here.

>[2] ask monk for box
The monk gestures at the top right corner of the screen. "Your score is too low for you to receive my blessing, traveler!" he says.

>ask monk for herrin
You can't see any such thing.

>ask monk for robe
The monk gestures at the top right corner of the screen. "Your score is too low for you to receive my blessing, traveler!" he says.

>ask monk for cash
The monk gestures at the top right corner of the screen. "Your score is too low for you to receive my blessing, traveler!" he says.

* * *

>test monk
(Testing.)

>[1] gonear monk
Island of Technique
This little island is no tropical paradise. It's more like someone carved a chunk off of Scotland and dropped it at the edge of the bay. Foggy, muddy, and riddled with trees.

You can see a monk here.

>[2] ask monk for box
The monk gestures at the top right corner of the screen. "Your score is too low for you to receive my blessing, traveler!" he says.

>l
Island of Technique
This little island is no tropical paradise. It's more like someone carved a chunk off of Scotland and dropped it at the edge of the bay. Foggy, muddy, and riddled with trees.

You can see a monk here.

>take box
That seems to belong to the monk.

* * *

>test monk
(Testing.)

>[1] gonear monk
Island of Technique
This little island is no tropical paradise. It's more like someone carved a chunk off of Scotland and dropped it at the edge of the bay. Foggy, muddy, and riddled with trees.

You can see a monk here.

>[2] ask monk for box
The monk gestures at the top right corner of the screen. "Your score is too low for you to receive my blessing, traveler!" he says.

>take box
The monk holds the wooden box out of your reach.

* * *

>test monk
(Testing.)

>[1] gonear monk
Island of Technique
This little island is no tropical paradise. It's more like someone carved a chunk off of Scotland and dropped it at the edge of the bay. Foggy, muddy, and riddled with trees.

You can see a monk here.

>[2] ask monk for box
The monk gestures at the top right corner of the screen. "Your score is too low for you to receive my blessing, traveler!" he says.

>test monk
(Testing.)

>[1] gonear monk
Island of Technique
This little island is no tropical paradise. It's more like someone carved a chunk off of Scotland and dropped it at the edge of the bay. Foggy, muddy, and riddled with trees.

You can see a monk here.

>[2] ask monk for box
The monk has better things to do.

>ask monk for the box
The monk has better things to do.

>ask monk for the robe
The monk shakes his head. "I do not such a thing to give you, traveler."

>i
You are carrying:
  a wallet
    5 kroner
    1 Uncle Sam

>l
Island of Technique
This little island is no tropical paradise. It's more like someone carved a chunk off of Scotland and dropped it at the edge of the bay. Foggy, muddy, and riddled with trees.

You can see a monk here.

>l monk
He stands solemnly, with his arms nearly enveloped by the sleeves of his robe. In one hand he carries a small wooden box.

* * *

>test monk-ask
(Testing.)

>[1] gonear monk
Island of Technique
This little island is no tropical paradise. It's more like someone carved a chunk off of Scotland and dropped it at the edge of the bay. Foggy, muddy, and riddled with trees.

You can see a monk here.

>[2] ask monk for box
The monk has better things to do.

>l
Island of Technique
This little island is no tropical paradise. It's more like someone carved a chunk off of Scotland and dropped it at the edge of the bay. Foggy, muddy, and riddled with trees.

You can see a monk here.

>i
You are carrying:
  the wooden box (closed)
  a wallet
    5 kroner
    1 Uncle Sam

>x box
Plainer than a raw herring.

>open box
You open the wooden box, revealing an ineffable mystery.

>l mystery
Did you really think your brain would figure this one out just by looking?

* * *

>test monk-ask
(Testing.)

>[1] gonear monk
Island of Technique
This little island is no tropical paradise. It's more like someone carved a chunk off of Scotland and dropped it at the edge of the bay. Foggy, muddy, and riddled with trees.

You can see a monk here.

>[2] ask monk for box
The monk has better things to do.

>l box
Plainer than a raw herring.

>l monk
He stands solemnly, with his hands folded in the sleeves of his robe. In one hand he carries a small wooden box.

* * *

>test monmk
>--> The following tests are available:
'test bungo'
'test pack'
'test apt'
'test leave'
'test vendor'
'test bird-a'
'test docktoplatform'
'test uptodock'
'test wait-a'
'test trainto'
'test uptocope'
'test ana'
'test butt'
'test monk'
'test inside-tree'

>test monk
(Testing.)

>[1] gonear monk
Island of Technique
This little island is no tropical paradise. It's more like someone carved a chunk off of Scotland and dropped it at the edge of the bay. Foggy, muddy, and riddled with trees.

You can see a monk here.

>[2] ask monk for box
The monk has better things to do.

* * *

>test pack
(Testing.)

>[1] get pack
Taken.

>est apt
That's not a verb I recognize.

* * *

>s
(first opening the apartment door)

Hellerup Strandvejen
The main street of Hellerup is bordered on its north side by brightly-painted row houses, such as the one containing your apartment. At the east end is a dock, and if you go west you can catch a train.

You can see an apartment door, a street vendor and a wheelbarrow (in which are a pile of herring and a mound of herring) here.

>buy herring
Which do you mean, the fistful of herring, the pile of herring or the mound of herring?

>buy pile
You pay 1 kroner for the pile of herring, leaving yourself with 4 kroner.

>e
Dock
This is a shabby little dock used for the fishing trade. At the end of the dock, a little rowboat, moored with a rope, bobs up and down. In the rowboat is a large crate, atop which sits a bird.

>give pile to bird
The wretched bird regards you warily, then opens its beak and snaps up the pile of herring. It swallows in one gulp.

You see a flash of brilliance in its black, beady eyes. Then it caws, and flies off in the direction of Copenhagen.

You feel strangely proud.

[Your score has just gone up by one point.]

* * *

>test pack
(Testing.)

>[1] get pack
Taken.

>get apt
You can't see any such thing.

>test apt
(Testing.)

>[1] x fridge
Silver, yet subtle. The handle is quite affordant..

>[2] open fridge
You open the fridge, revealing a piece of cheese, a steak and a glass bottle.

>[3] x bottle
It contains some Dankdrinke.

In the glass bottle is some Dankdrinke.

>[4] open bottle
You open the glass bottle.

>[5] x dankdrinke
No drinke is more ergonomik than Dankdrinke!

>[6] drink dankdrinke
(first taking the Dankdrinke)
Your throat is filled with ergonomitivity.

[Your score has just gone up by one point.]

>[7] x sheets
Extremely rumpled from excessive romping.

>[8] x panties
Pink and frilly. You should probably return those.

>[9] x rug
The rug depicts a scene of universal healthcare flying over a lake.

>[10] take panties
Nice.

[Your score has just gone up by one point.]

>test leave
(Testing.)

>[1] go south
(first opening the apartment door)

Hellerup Strandvejen
The main street of Hellerup is bordered on its north side by brightly-painted row houses, such as the one containing your apartment. At the east end is a dock, and if you go west you can catch a train.

You can see a street vendor and a wheelbarrow (in which are a pile of herring and a mound of herring) here.

The vendor eyes your backpack.

>r
Time passes.

The vendor eyes your pair of Central European panties.

>r
Time passes.

The vendor eyes your wallet.

>r
Time passes.

The vendor eyes your pair of Central European panties.

>r
Time passes.

The vendor eyes your backpack.

>r
Time passes.

The vendor eyes your wallet.

>r
Time passes.

The vendor eyes your backpack.

>test vendor
(Testing.)

>[1] buy pile
You pay 1 kroner for the pile of herring, leaving yourself with 4 kroner.

The vendor eyes your pile of herring.

>[2] buy mound
You pay 2 kroner for the mound of herring, leaving yourself with 2 kroner.

The vendor eyes your wallet.

>e
Dock
This is a shabby little dock used for the fishing trade. At the end of the dock, a little rowboat, moored with a rope, bobs up and down. In the rowboat is a large crate, atop which sits a bird.

>feed pile to bird
The wretched bird regards you warily, then opens its beak and snaps up the pile of herring. It swallows in one gulp.

You see a flash of brilliance in its black, beady eyes. Then it caws, and flies off in the direction of Copenhagen.

You feel strangely proud.

[Your score has just gone up by one point.]

>test docktoplatform
(Testing.)

>[1] w

Hellerup Strandvejen
The main street of Hellerup is bordered on its north side by brightly-painted row houses, such as the one containing your apartment. At the east end is a dock, and if you go west you can catch a train.

You can see a street vendor and a wheelbarrow (empty) here.

The vendor eyes your wallet.

>[2] w

Train Platform
The open-air train platform has a line that runs to Copenhagen every 10 minutes. There are no tickets: just line up and wait for the next train to come.

You can see a paper kroner here.

>wait-a
That's not a verb I recognize.

>test wait-a
(Testing.)

>[1] take paper kroner
You gain 1 kroner.

The C-Train arrives.

>[2] r
Time passes.

>[3] r
Time passes.

>[4] r
Time passes.

>enter
You get into the C-Train.

>r
Time passes.

The C-Train departs, taking you into a tunnel.

>l
Train Tunnel (in the C-Train)

>r
Time passes.

>l
Train Tunnel (in the C-Train)

>l
Train Tunnel (in the C-Train)

>l
Train Tunnel (in the C-Train)
You arrive in Copenhagen.

>x
What do you want to examine?

I beg your pardon?

>exit
Copenhagen Metro Station
This is the main metro station in Copenhagen. Its creator won the Best Dane of the Year Award.

Stairs lead southward and upward to the IIT Campus exit. Christiana is northwest of here: this much you know.

A small door stands in the southeast corner of the station near a fake tree.

You can see a C-Train (empty) here.

>xit
That's not a verb I recognize.

>exit
But you aren't in anything at the moment.

>southeast
(first opening the small unmarked door)

The Path
This odd little path runs out of the metro station and toward an isolated hill overlooking the bay. The ground is grassy, but the only larger vegetation is a gnarled bush.

>w
You can't go that way.

>n
You can't go that way.

>e
You can't go that way.

>s
The Hill

>l
The Hill

>w
You can't go that way.

* * *

>e
You can't go that way.

>n
The Path
This odd little path runs out of the metro station and toward an isolated hill overlooking the bay. The ground is grassy, but the only larger vegetation is a gnarled bush.

>w
You can't go that way.

>nw
Copenhagen Metro Station
This is the main metro station in Copenhagen. Its creator won the Best Dane of the Year Award.

Stairs lead southward and upward to the IIT Campus exit. Christiana is northwest of here: this much you know.

A small door stands in the southeast corner of the station near a fake tree.

>w
Aarenhus Cemetery
Dark paths run here and there among the marble tombs.

You can see the friendly bird here.

>l
Aarenhus Cemetery
Dark paths run here and there among the marble tombs.

You can see the friendly bird here.

>e
Copenhagen Metro Station
This is the main metro station in Copenhagen. Its creator won the Best Dane of the Year Award.

Stairs lead southward and upward to the IIT Campus exit. Christiana is northwest of here: this much you know.

A small door stands in the southeast corner of the station near a fake tree.

>s
IIT Campus
The campus is pretty sleepy in the summer. A construction crew works below the bell tower, but the only student you see is Ana..

You can see a girl named Ana here.

>x ana
A Czech girl. Starting next week, she's your TA for Introductory Programming.You haven't seen her since she spent the night last Friday.

>give panties to ana
You can only do that to something animate.

>give ana panties
You can only do that to something animate.

>give
What do you want to give yourself?

>dankdrinke
You can't see any such thing.

>give ana
(to yourself)
(first taking the girl named Ana)
(putting the wallet into the backpack to make room)
You're carrying too many things already.

>i
You are carrying:
  a mound of herring
  a pair of Central European panties
  a backpack (open)
    a wallet
      3 kroner
      1 Uncle Sam

>drop mound
Dropped.

>drop panties
Dropped.

>take ana
Taken.

>i
You are carrying:
  a girl named Ana
  a backpack (open)
    a wallet
      3 kroner
      1 Uncle Sam

* * *

>test pack
(Testing.)

>[1] get pack
Taken.

>test apt
(Testing.)

>[1] x fridge
Silver, yet subtle. The handle is quite affordant.

>[2] open fridge
You open the fridge, revealing a piece of cheese, a steak and a glass bottle of Dankdrinke.

>[3] x bottle
No drinke is more ergonomik than Dankdrinke!

>[4] open bottle
It isn't something you can open.

>[5] x dankdrinke
No drinke is more ergonomik than Dankdrinke!

>[6] drink dankdrinke
It isn't something you can open.

Foolish American, have you truly mistaken the glass bottle of Dankdrinke for food?

>[7] x sheets
Extremely rumpled from excessive romping.

>[8] x panties
Pink, frilly, and definitely not yours.

>[9] x rug
The rug depicts a scene of universal healthcare flying over a lake.

>[10] take panties
Nice.

>[11] take banana tree
(putting the wallet into the backpack to make room)
Taken.

* * *

>test pack / test apt
I only understood you as far as wanting to test that.

* * *

>test pack
(Testing.)

>[1] get pack
Taken.

>test
>--> The following tests are available:
'test pack'
'test apt'
'test leave'
'test vendor'
'test bird-a'
'test docktoplatform'
'test uptodock'
'test wait-a'
'test trainto'
'test uptocope'
'test ana'

>test apt
(Testing.)

>[1] x fridge
Silver, yet subtle. The handle is quite affordant..

>[2] open fridge
You open the fridge, revealing a piece of cheese, a steak and a glass bottle.

>[3] x bottle
It contains some Dankdrinke.

In the glass bottle is some Dankdrinke.

>[4] open bottle
You open the glass bottle.

>[5] x dankdrinke
No drinke is more ergonomik than Dankdrinke!

>[6] drink dankdrinke
(first taking the Dankdrinke)
Your throat is filled with ergonomitivity.

[Your score has just gone up by one point.]

>[7] x sheets
Extremely rumpled from excessive romping.

>[8] x panties
Pink and frilly. You should probably return those.

>[9] x rug
The rug depicts a scene of universal healthcare flying over a lake.

>[10] take panties
Nice.

>[11] take banana tree
(putting the wallet into the backpack to make room)

* * *

>s
(first opening the apartment door)

Hellerup Strandvejen
The main street of Hellerup is bordered on its north side by brightly-painted row houses, such as the one containing your apartment. At the east end is a dock, and if you go west you can catch a train.

You can see an apartment door, a street vendor and a wheelbarrow (in which are a pile of herring and a mound of herring) here.

>r
Time passes.

>r
Time passes.

"L2" = text: pile of herring and mound of herring
The vendor calls out, "Today I have a pile of herring and a mound of herring! Fresh!"

>buy pile. buy mound
You pay 1 kroner for the pile of herring, leaving yourself with 4 kroner.

You pay 2 kroner for the mound of herring, leaving yourself with 2 kroner.

>r
Time passes.

>r
Time passes.

"L2" = text: 
The vendor winks at you.

>r
Time passes.

"L2" = text: 
The vendor taps his foot.

>r
Time passes.

>r
Time passes.

"L2" = text: 
The vendor grins cheerfully.

>r
Time passes.

>r
Time passes.

"L2" = text: 
The vendor taps his foot.

* * *

>r
Time passes.

>l
Hellerup Strandvejen
The main street of Hellerup is bordered on its north side by brightly-painted row houses, such as the one containing your apartment. At the east end is a dock, and if you go west you can catch a train.

You can see an apartment door, a street vendor and a wheelbarrow (empty) here.

>l houses
You see nothing special about the row houses.

"L2" = text: 
The vendor winks at you.

>l west
You see nothing unexpected in that direction.

>doors
That's not a verb I recognize.

>exits
That's not a verb I recognize.

>e
Dock
This is a shabby little dock used for the fishing trade. At the end of the dock, a little rowboat, moored with a rope, bobs up and down. In the rowboat is a large crate, atop which sits a bird.

>w
Hellerup Strandvejen
The main street of Hellerup is bordered on its north side by brightly-painted row houses, such as the one containing your apartment. At the east end is a dock, and if you go west you can catch a train.

You can see an apartment door, a street vendor and a wheelbarrow (empty) here.

"L2" = text: 
The vendor taps his foot.

>uptocope
That's not a verb I recognize.

I beg your pardon?

>test uptocope
(Testing.)

>[1] test uptodock
(Testing.)

>[2] test pack
(Testing.)

>[3] get pack
You already have that.

"L2" = text: 
The vendor grins cheerfully.

>[4] test apt
(Testing.)

>[5] x fridge
You can't see any such thing.

>[6] open fridge
You can't see any such thing.

>[7] x bottle
You can't see any such thing.

>[8] open bottle
You can't see any such thing.

>[9] x dankdrinke
You can't see any such thing.

>[10] drink dankdrinke
You can't see any such thing.

>[11] x sheets
You can't see any such thing.

>[12] x panties
Pink and frilly. You should probably return those.

>[13] x rug
You can't see any such thing.

>[14] take panties
You already have that.

>[15] take banana tree
You already have that.

"L2" = text: 
The vendor winks at you.

>[16] test leave
(Testing.)

>[17] go south
You can't go that way.

>[18] test vendor
(Testing.)

>[19] buy pile
That doesn't cost any money.
You already have that.

>[20] buy mound
That doesn't cost any money.
You already have that.

"L2" = text: 
The vendor taps his foot.

>[21] test bird-a
(Testing.)

>[22] e

Dock
This is a shabby little dock used for the fishing trade. At the end of the dock, a little rowboat, moored with a rope, bobs up and down. In the rowboat is a large crate, atop which sits a bird.

>[23] feed pile to bird
The wretched bird regards you warily, then opens its beak and snaps up the pile of herring. It swallows in one gulp.

You see a flash of brilliance in its black, beady eyes. Then it caws, and flies off in the direction of Copenhagen.

You feel strangely proud.

[Your score has just gone up by one point.]

>[24] w

Hellerup Strandvejen
The main street of Hellerup is bordered on its north side by brightly-painted row houses, such as the one containing your apartment. At the east end is a dock, and if you go west you can catch a train.

You can see an apartment door, a street vendor and a wheelbarrow (empty) here.

"L2" = text: 
The vendor winks at you.

>[25] w

Train Platform
The open-air train platform has a line that runs to Copenhagen every 10 minutes. There are no tickets: just line up and wait for the next train to come.

You can see a paper kroner here.

>[26] test wait-a
(Testing.)

>[27] take kroner
You gain 1 kroner.

>[28] r
Time passes.

>[29] r
Time passes.

>[30] r
Time passes.

>[31] r
Time passes.

>[32] r
Time passes.

>[33] r
Time passes.

>[34] test trainto
(Testing.)

>[35] enter train
You can't see any such thing.

>[36] r
Time passes.

>[37] r
Time passes.

>[38] r
Time passes.

>[39] r
Time passes.

>[40] r
Time passes.

>[41] r
Time passes.

>[42] r
Time passes.

The C-Train arrives.

>[43] r
Time passes.

>[44] r
Time passes.

>[45] exit
But you aren't in anything at the moment.

I beg your pardon?

>nter
That's not a verb I recognize.

>enter
You get into the C-Train.

* * *

>r
Time passes.

>exit
Copenhagen Metro Station
This is the main metro station in Copenhagen. Its creator won the Best Dane of the Year Award.

Stairs lead southward and upward to the IIT Campus exit. Christiana is northwest of here: this much you know.

The Danes are very efficient: you can also take a direct route west from here to the Aarenhus Cemetery.

A small door stands in the southeast corner of the station near a fake tree.

You can see a C-Train (empty) here.

>open fake tree
You can't see any such thing.

>open tree
It isn't something you can open.

* * *

>test up tocope
I only understood you as far as wanting to test that.

* * *

>w
Aarenhus Cemetery
Dark paths run here and there among the marble tombs. Some trees provide relaxing shade, while small flowers bloom here and there.

You can see the friendly bird here.

>take flower
You can't see any such thing.

>take flowers
You can't see any such thing.

>take a flower
You can't see any such thing.

* * *

>test uptocop
>--> The following tests are available:
'test pack'
'test apt'
'test leave'
'test vendor'
'test bird-a'
'test docktoplatform'
'test uptodock'
'test wait-a'
'test trainto'
'test uptocope'
'test ana'

* * *

I beg your pardon?

>w
Aarenhus Cemetery
Dark paths run here and there among the marble tombs. Some trees provide relaxing shade, and white flowers bloom here and there.

You can see the friendly bird and several flowers here.

>e
Copenhagen Metro Station
This is the main metro station in Copenhagen. Its creator won the Best Dane of the Year Award.

Stairs lead southward and upward to the IIT Campus exit. Christiana is northwest of here: this much you know.

The Danes are very efficient: you can also take a direct route west from here to the Aarenhus Cemetery.

A small door stands in the southeast corner of the station near a fake tree.

You can see a C-Train (empty) and the fake tree here.

>s
IIT Campus
The campus is pretty sleepy in the summer. A construction crew works below the bell tower, but the only student you see is Ana.

You can see Ana and a stone bench here.

>take ana
Ana is incensed. "Trying to take me in in public?! What would your glorious Washington think of that?"

>take ana
Ana is incensed. "Trying to take me in in public?! What would your precious Hamilton think of that?"

>take ana
Ana is incensed. "Trying to take me in in public?! What would your exalted Lincoln think of that?"

>take ana
Ana is incensed. "Trying to take me in in public?! What would your glorious Washington think of that?"

* * *

>take ana
Ana is incensed. "Trying to take me in in public?! What would your precious Hamilton think of that?"

>take ana
Ana is incensed. "Trying to take me in in public?! What would your glorious Lincoln think of that?"

>take ana
Ana is incensed. "Trying to take me in in public?! What would your exalted Hamilton think of that?"

>take ana
Ana is incensed. "Trying to take me in in public?! What would your glorious Jefferson think of that?"

>take ana
Ana is incensed. "Trying to take me in in public?! What would your exalted Washington think of that?"

>take ana
Ana is incensed. "Trying to take me in in public?! What would your precious Lincoln think of that?"

>take ana
Ana is incensed. "Trying to take me in in public?! What would your exalted Hamilton think of that?"

>take ana
Ana is incensed. "Trying to take me in in public?! What would your precious Washington think of that?"

>take ana
Ana is incensed. "Trying to take me in in public?! What would your exalted Lincoln think of that?"

>take ana
Ana is incensed. "Trying to take me in in public?! What would your glorious Jefferson think of that?"

>take ana
Ana is incensed. "Trying to take me in in public?! What would your precious Washington think of that?"

>tak ana
That's not a verb I recognize.

>take ana
Ana is incensed. "Trying to take me in in public?! What would your glorious Lincoln think of that?"

>take ana
Ana is incensed. "Trying to take me in in public?! What would your exalted Washington think of that?"

>take ana
Ana is incensed. "Trying to take me in in public?! What would your glorious Hamilton think of that?"

>take ana
Ana is incensed. "Trying to take me in in public?! What would your exalted Jefferson think of that?"

>take ana
Ana is incensed. "Trying to take me in in public?! What would your glorious Lincoln think of that?"

>take ana
Ana is incensed. "Trying to take me in in public?! What would your exalted Jefferson think of that?"

* * *

>take ana
Ana is incensed. "Trying to take me in in public?! What would your glorious Lincoln think of that?"

>take ana
Ana is incensed. "Trying to take me in in public?! What would your precious Washington think of that?"

* * *

>take ana
Ana is incensed. "Trying to take me in in public?! What would your glorious Washington think of that?"

>take ana
Ana is incensed. "Trying to take me in in public?! What would your precious Lincoln think of that?"

>take ana
Ana is incensed. "Trying to take me in in public?! What would your glorious Jefferson think of that?"

>take ana
Ana is incensed. "Trying to take me in in public?! What would your precious Hamilton think of that?"

>take ana
Ana is incensed. "Trying to take me in in public?! What would your glorious Washington think of that?"

* * *

>take ana
Ana is incensed. "Trying to take me in in public?! What would your precious Lincoln think of that?"

>take ana
Ana is incensed. "Trying to take me in in public?! What would your exalted Washington think of that?"

>take ana
Ana is incensed. "Trying to take me in in public?! What would your precious Hamilton think of that?"

>take ana
Ana is incensed. "Trying to take me in in public?! What would your exalted Jefferson think of that?"

>take ana
Ana is incensed. "Trying to take me in in public?! What would your precious Lincoln think of that?"

* * *

>take ana
Ana is incensed. "Trying to take me in in public?! What would your glorious Jefferson think of that?"

>n.w
Copenhagen Metro Station
This is the main metro station in Copenhagen. Its creator won the Best Dane of the Year Award.

Stairs lead southward and upward to the IIT Campus exit. Christiana is northwest of here: this much you know.

The Danes are very efficient: you can also take a direct route west from here to the Aarenhus Cemetery.

A small door stands in the southeast corner of the station near a fake tree.

You can see a C-Train (empty) and the fake tree here.

Aarenhus Cemetery
Dark paths run here and there among the marble tombs. Some trees provide relaxing shade, and white flowers bloom here and there.

You can see the friendly bird and several flowers here.

>take flower
You pluck a flower from where it grows.

>take 3 flowers
flower: You pluck a flower from where it grows.
flower: You pluck a flower from where it grows.
flower: You pluck a flower from where it grows.

>e
Copenhagen Metro Station
This is the main metro station in Copenhagen. Its creator won the Best Dane of the Year Award.

Stairs lead southward and upward to the IIT Campus exit. Christiana is northwest of here: this much you know.

The Danes are very efficient: you can also take a direct route west from here to the Aarenhus Cemetery.

A small door stands in the southeast corner of the station near a fake tree.

You can see the fake tree here.

>s
IIT Campus
The campus is pretty sleepy in the summer. A construction crew works below the bell tower, but the only student you see is Ana.

You can see Ana and a stone bench here.

>give ana flower
She slaps the flower out of your hand.

>give ana a flower
She slaps the flower out of your hand.

>i
You are carrying:
  two flowers
  a mound of herring
  a dwarf banana tree
  a pair of Central European panties
  a backpack (open)
    a wallet
      3 kroner
      1 Uncle Sam

>take 2 flowers
flower: (putting the pair of Central European panties into the backpack to make room)
You're carrying too many things already.
flower: (putting the dwarf banana tree into the backpack to make room)
You're carrying too many things already.

>i
You are carrying:
  two flowers
  a mound of herring
  a backpack (open)
    a dwarf banana tree
    a pair of Central European panties
    a wallet
      3 kroner
      1 Uncle Sam

>take flower
(putting the mound of herring into the backpack to make room)
You're carrying too many things already.

>i
You are carrying:
  two flowers
  a backpack (open)
    a mound of herring
    a dwarf banana tree
    a pair of Central European panties
    a wallet
      3 kroner
      1 Uncle Sam

>take flower
(putting the flower into the backpack to make room)
Taken.

>i
You are carrying:
  two flowers
  a backpack (open)
    a flower
    a mound of herring
    a dwarf banana tree
    a pair of Central European panties
    a wallet
      3 kroner
      1 Uncle Sam

>give flower
(to Ana)
She slaps the flower out of your hand.

>give panties
(to Ana)
She slaps the pair of Central European panties out of your hand.

* * *

I beg your pardon?

>s
IIT Campus
The campus is pretty sleepy in the summer. A construction crew works below the bell tower, but the only student you see is Ana.

You can see Ana and a stone bench here.

>talk ana
That's not a verb I recognize.

* * *

>talk to ana
That's not a verb I recognize.

>x aa
You can't see any such thing.

>x ana
A Czech girl. Starting next week, she's your TA for Introductory Programming. Starting last night, she's your lover.

>take ana
Ana is incensed. "Trying to take me in in public?! What would yourglorious Lincoln think of that?"

>i
You are carrying:
  a mound of herring
  a dwarf banana tree
  a pair of Central European panties
  a backpack (open)
    a wallet
      3 kroner
      1 Uncle Sam

>give tree to ana
She slaps the dwarf banana tree out of your hand.

>give herring to ana
She slaps the mound of herring out of your hand.

>l
IIT Campus
The campus is pretty sleepy in the summer. A construction crew works below the bell tower, but the only student you see is Ana.

You can see a mound of herring, a dwarf banana tree, Ana and a stone bench here.

>give bench toana
You can only do that to something animate.

>give bench to ana
She slaps the stone bench out of your hand.

* * *

I beg your pardon?

>e
(first opening the fake tree)
To your surprise, this tree is actually door!

Zone
Dark and gloomy in here.

You can see the fake tree and an altar here.

>w
You can't go that way.

>u
Copenhagen Metro Station
This is the main metro station in Copenhagen. Its creator won the Best Dane of the Year Award.

Stairs lead southward and upward to the IIT Campus exit. Christiana is northwest of here: this much you know.

The Danes are very efficient: you can also take a direct route west from here to the Aarenhus Cemetery.

A small door stands in the southeast corner of the station near a fake tree.

You can see the fake tree here.

* * *

I beg your pardon?

>l tree
(the dwarf banana tree)
As friendly as a plant can get, and eminently pocketable.

>l fake tree
You see nothing special about the fake tree.

>open fake tree
To your surprise, this tree is actually door!

It isn't something you can open.

The C-Train departs without you.

* * *

I beg your pardon?

>s
IIT Campus
The campus is pretty sleepy in the summer. A construction crew works below the bell tower, but the only student you see is Ana.

You can see a woman named Ana here.

>give panties to ana
You can only do that to something animate.

>give ana
(to yourself)
(first taking the woman named Ana)
Ana is incensed. "Taking me in in public? I am not your Uncle Sam whore!"

>give panties ana
You can only do that to something animate.

>give ana panties
You can only do that to something animate.

>give panties to anaa
You can't see any such thing.

>give panties to ana
You can only do that to something animate.

>ana, take panties
You can't talk to the woman named Ana.

>ana
That's not a verb I recognize.

>take ana
Ana is incensed. "Taking me in in public? I am not your Uncle Sam whore!"

>give ana me
You can only do that to something animate.

>give me ana
(first taking the woman named Ana)
Ana is incensed. "Taking me in in public? I am not your Uncle Sam whore!"

>give ana panties
You can only do that to something animate.

>give ana
(to yourself)
(first taking the woman named Ana)
Ana is incensed. "Taking me in in public? I am not your Uncle Sam whore!"

>give panties
(to yourself)
You can't give the pair of Central European panties to yourself.

>give panties ana
You can only do that to something animate.

>give panties to ana
You can only do that to something animate.

>FUCK
That's not a verb I recognize.

* * *

>w
Aarenhus Cemetery
Dark paths run here and there among the marble tombs. Some trees provide relaxing shade, and white flowers bloom here and there.

You can see the friendly bird and several flowers here.

>l
Aarenhus Cemetery
Dark paths run here and there among the marble tombs.

You can see the friendly bird here.

>x bird
The bird has more energy than when you first encountered it. Its plumage now has a healthy sheen.

* * *

>w
Aarenhus Cemetery
Dark paths run here and there among the marble tombs. Some trees provide relaxing shade, and white flowers bloom here and there.

You can see the friendly bird and several flowers here.

>take 3 flower
flower: You pluck a flower from where it grows.
flower: You pluck a flower from where it grows.
flower: You pluck a flower from where it grows.

>es
That's not a verb I recognize.

>e.s
Copenhagen Metro Station
This is the main metro station in Copenhagen. Its creator won the Best Dane of the Year Award.

Stairs lead southward and upward to the IIT Campus exit. Christiana is northwest of here: this much you know.

The Danes are very efficient: you can also take a direct route west from here to the Aarenhus Cemetery.

A small door stands in the southeast corner of the station near a fake tree.

You can see a C-Train (empty) and the fake tree (closed) here.

The C-Train departs without you.

IIT Campus
The campus is pretty sleepy in the summer. A construction crew works below the bell tower, but the only student you see is Ana.

You can see Ana and a stone bench here.

>give ana flower
Ana sighs and kisses your cheek. She strolls over to the bench, and sits down to gaze at the flower.

[Your score has just gone up by one point.]

>take ana
Ana is incensed. "Trying to take me in in public?! What would your glorious Hamilton think of that?"

>give ana flower
Ana giggles.

>give ana flower
Ana grins.

>give ana flower
(first taking the flower)
That seems to belong to Ana.

* * *

>w
Aarenhus Cemetery
Dark paths run here and there among the marble tombs. Some trees provide relaxing shade, and white flowers bloom here and there.

You can see the friendly bird and several flowers here.

>take flowers
(putting the pair of Central European panties into the backpack to make room)
You're carrying too many things already.

>i
You are carrying:
  a mound of herring
  a dwarf banana tree
  a backpack (open)
    a pair of Central European panties
    a wallet
      3 kroner
      1 Uncle Sam

>take flowers
(putting the dwarf banana tree into the backpack to make room)
Taken.

>x flowers
They grow all over the place.

>drop flowers
Dropped.

* * *

I beg your pardon?

>x door
It's not even a finished door - just a plank of wood on hinges. The hand-lettered sign reads, "In case you haven't noticed, you've gotten 2 points so far."

* * *

>s
IIT Campus
The campus is pretty sleepy in the summer. A construction crew works below the bell tower, but the only student you see is Ana.

You can see Ana here.

>give panties ana
You can only do that to something animate.

>give panties to aana
You can't see any such thing.

>give panties to ana
You can only do that to something animate.

* * *

>give ana panties
You can only do that to something animate.

>give ana
(to yourself)
You doesn't want anything from you.

* * *

>s
IIT Campus
The campus is pretty sleepy in the summer. A construction crew works below the bell tower, but the only student you see is Ana.

You can see Ana here.

>l
IIT Campus
The campus is pretty sleepy in the summer. A construction crew works below the bell tower, but the only student you see is Ana.

You can see a woman named Ana here.

>x ana
A Czech girl. Starting next week, she's your TA for Introductory Programming. Starting last night, she's your lover.

>give panties ana
You can only do that to something animate.

* * *

>give panties to ana
You can only do that to something animate.

>give panties to Ana
You can only do that to something animate.

>l
IIT Campus
The campus is pretty sleepy in the summer. A construction crew works below the bell tower, but the only student you see is Ana.

You can see a woman named Ana here.

>i
You are carrying:
  a mound of herring
  a pair of Central European panties
  a backpack (open but empty)
  a wallet
    3 kroner
    1 Uncle Sam

>take panties
You already have that.

>give Ana panties
You can only do that to something animate.

* * *

>s
IIT Campus
The campus is pretty sleepy in the summer. A construction crew works below the bell tower, but the only student you see is Ana.

You can see Ana here.

>talk ana
That's not a verb I recognize.

* * *

>talk to ana
That's not a verb I recognize.

>give tree to ana
She slaps your hand away.

>show tree to ana
Ana slaps the dwarf banana tree out of your hand.

* * *

>se
(first opening the small door)

The Path
This odd little path runs out of the metro station and toward an isolated hill overlooking the bay. The ground is grassy, but the only larger vegetation is a gnarled bush.

>nw
Copenhagen Metro Station
This is the main metro station in Copenhagen. Its creator won the Best Dane of the Year Award.

Stairs lead southward and upward to the IIT Campus exit. Christiana is northwest of here: this much you know.

The Danes are very efficient: you can also take a direct route from here to the Aarenhus Cemetery.

A small door stands in the southeast corner of the station near a fake tree.

You can see a C-Train (empty) here.

* * *

>test ana
(Testing.)

>[1] s

IIT Campus
The campus is pretty sleepy in the summer. A construction crew works below the bell tower, but the only student you see is Ana.

You can see Ana here.

>[2] give banana tree to ana
She slaps your hand away.

>[3] show banana tree to ana
Ana slaps the dwarf banana tree out of your hand.

>[4] take banana tree
(putting the pair of Central European panties into the backpack to make room)
>[5] take ana
Ana is incensed. "Trying to take me in in public?!"

>[6] give panties to ana
(first taking the pair of Central European panties)
(putting the mound of herring into the backpack to make room)
She blushes, snatches the pair of Central European panties, and storms off.

[Your score has just gone up by one point.]

>i
You are carrying:
  a mound of herring
  a backpack (open but empty)
  a wallet
    3 kroner
    1 Uncle Sam

* * *

>test anan
>--> The following tests are available:
'test pack'
'test apt'
'test leave'
'test vendor'
'test bird-a'
'test docktoplatform'
'test uptodock'
'test wait-a'
'test trainto'
'test uptocope'
'test ana'

I beg your pardon?

>n
Copenhagen Metro Station
This is the main metro station in Copenhagen. Its creator won the Best Dane of the Year Award.

Stairs lead southward and upward to the IIT Campus exit. Christiana is northwest of here: this much you know.

The Danes are very efficient: you can also take a direct route west from here to the Aarenhus Cemetery.

A small door stands in the southeast corner of the station near a fake tree.

>up
IIT Campus
The campus is pretty sleepy in the summer. A construction crew works below the bell tower, but no students are to be seen.

>n
Copenhagen Metro Station
This is the main metro station in Copenhagen. Its creator won the Best Dane of the Year Award.

Stairs lead southward and upward to the IIT Campus exit. Christiana is northwest of here: this much you know.

The Danes are very efficient: you can also take a direct route west from here to the Aarenhus Cemetery.

A small door stands in the southeast corner of the station near a fake tree.

>nw
Christiana Main Street
This street is lined with drug pushers, filled with tourists, dotted with hippies, and sprinkled with musicians.

You can see a pusher here.

* * *

>w
Aarenhus Cemetery
Dark paths run here and there among the marble tombs. Some trees provide relaxing shade, and white flowers bloom here and there.

You can see the friendly bird and several flowers here.

I beg your pardon?

>take 3 flower
flower: You pluck a flower from where it grows.
flower: You pluck a flower from where it grows.
flower: You pluck a flower from where it grows.

>sn.
That's not a verb I recognize.

>s.n
You can't go that way.

You can't go that way.

>e.s
Copenhagen Metro Station
This is the main metro station in Copenhagen. Its creator won the Best Dane of the Year Award.

Stairs lead southward and upward to the IIT Campus exit. Christiana is northwest of here: this much you know.

The Danes are very efficient: you can also take a direct route west from here to the Aarenhus Cemetery.

A small door stands in the southeast corner of the station near a fake tree.

You can see the fake tree (closed) here.

IIT Campus
The campus is pretty sleepy in the summer. A construction crew works below the bell tower, but the only student you see is Ana.

You can see Ana and a stone bench here.

>give ana flower
Ana sighs and kisses your cheek. She strolls over to the bench, and sits down to gaze at the flower.

[Your score has just gone up by one point.]

>give ana flower
Ana giggles.

* * *

>give ana flower
(first taking the flower)
That seems to belong to Ana.

>give pot
You can't see any such thing.

>give panties
(to Ana)
She blushes, snatches the pair of Central European panties, and flounces off.

[Your score has just gone up by one point.]

>take ana
You can't see any such thing.

>take aa
You can't see any such thing.

* * *

>w
Aarenhus Cemetery
Dark paths run here and there among the marble tombs. Some trees provide relaxing shade, and white flowers bloom here and there.

You can see the friendly bird and several flowers here.

>look bird
The bird seems to have regained some energy after eating pile of herring. Its plumage has a healthy sheen.

>feed herring
What do you want to feed the mound of herring to?

>bird
*** Run-time problem P54: Tried to move The Path (not a thing) to the gnarled bush, but only things can move around.

The friendly bird nuzzles your hand, then gently spears the mound of herring with its beak. It jerks its head, tossing the mound of herring into the air, then leaps into the air to grab it.

It circles lazily above you for a minute or two, then soars off elsewhere.

[Your score has just gone up by one point.]

* * *

>w
Aarenhus Cemetery
Dark paths run here and there among the marble tombs. Some trees provide relaxing shade, and white flowers bloom here and there.

You can see the friendly bird and several flowers here.

>take lower
You can't see any such thing.

>take flower
You pluck a flower from where it grows.

>i
You are carrying:
  a flower
  a mound of herring
  a dwarf banana tree
  a pair of Central European panties
  a backpack (open)
    a wallet
      3 kroner
      1 Uncle Sam

>take flower
You pluck a flower from where it grows.

>i
You are carrying:
  several flowers
  a mound of herring
  a dwarf banana tree
  a pair of Central European panties
  a backpack (open)
    a wallet
      3 kroner
      1 Uncle Sam

>x flower
Cheery white.

>x flower
Cheery white.

>x second flower
You can't see any such thing.

>x flower
Cheery white.

>take flower
You pluck a flower from where it grows.

>x flower
Slender and delicate.

>drop flower
Dropped.

>i
You are carrying:
  several flowers
  a mound of herring
  a dwarf banana tree
  a pair of Central European panties
  a backpack (open)
    a wallet
      3 kroner
      1 Uncle Sam

>drop flower
Dropped.

>drop flower
Dropped.

>i
You are carrying:
  a mound of herring
  a dwarf banana tree
  a pair of Central European panties
  a backpack (open)
    a wallet
      3 kroner
      1 Uncle Sam

* * *

>w
Aarenhus Cemetery
Dark paths run here and there among the marble tombs. Some trees provide relaxing shade, and white flowers bloom here and there.

You can see the friendly bird and several flowers here.

>x flowers
They grow all over the place.

>take flowers
That's hardly portable.

>i
You are carrying:
  a mound of herring
  a dwarf banana tree
  a pair of Central European panties
  a backpack (open)
    a wallet
      3 kroner
      1 Uncle Sam

>eat flowers
That's definitely not edible.

* * *

>x door
It's not even a finished door - just a plank of wood on hinges. A sign hangs from a nail in the middle.

>x sign
The hand-lettered sign reads, "In case you haven't noticed, you've gotten 2 points so far."

>tits
That's not a verb I recognize.

>s
IIT Campus
The campus is pretty sleepy in the summer. A construction crew works below the bell tower, but the only student you see is Ana.

You can see Ana and a stone bench here.

* * *

>take ana
Ana is incensed. "Trying to take me in in public?! What would your glorious Washington think of that?"

>take ana
You can't take a living thing!

>take ana
You can't take a living thing!

>take Ana
You can't take a living thing!

* * *

>test uptodock
(Testing.)

>[1] test pack
(Testing.)

>[2] get pack
Taken.

>[3] test apt
(Testing.)

>[4] x fridge
Silver, yet subtle. The handle is quite affordant..

>[5] open fridge
You open the fridge, revealing a piece of cheese, a steak and a glass bottle.

>[6] x bottle
It contains some Dankdrinke.

In the glass bottle is some Dankdrinke.

>[7] open bottle
You open the glass bottle.

>[8] x dankdrinke
No drinke is more ergonomik than Dankdrinke!

>[9] drink dankdrinke
(first taking the Dankdrinke)
Your throat is filled with ergonomitivity.

[Your score has just gone up by one point.]

>[10] x sheets
Extremely rumpled from excessive romping.

>[11] x panties
Pink and frilly. You should probably return those.

>[12] x rug
The rug depicts a scene of universal healthcare flying over a lake.

>[13] take panties
Nice.

[Your score has just gone up by one point.]

>[14] test leave
(Testing.)

>[15] go south
(first opening the apartment door)

Hellerup Strandvejen
The main street of Hellerup is bordered on its north side by brightly-painted row houses, such as the one containing your apartment. At the east end is a dock, and if you go west you can catch a train.

You can see a street vendor and a wheelbarrow (in which are a pile of herring and a mound of herring) here.

The vendor eyes your pair of Central European panties.

>[16] test vendor
(Testing.)

>[17] buy pile
You pay 1 kroner for the pile of herring, leaving yourself with 4 kroner.

The vendor eyes your pile of herring.

>[18] buy mound
You pay 2 kroner for the mound of herring, leaving yourself with 2 kroner.

The vendor eyes your pile of herring.

>[19] test bird-a
(Testing.)

>[20] e

Dock
This is a shabby little dock used for the fishing trade. At the end of the dock, a little rowboat, moored with a rope, bobs up and down. In the rowboat is a large crate, atop which sits a bird.

>[21] feed pile to bird
The wretched bird regards you warily, then opens its beak and snaps up the pile of herring. It swallows in one gulp.

You see a flash of brilliance in its black, beady eyes. Then it caws, and flies off in the direction of Copenhagen.

You feel strangely proud.

[Your score has just gone up by one point.]

I beg your pardon?

>w
Hellerup Strandvejen
The main street of Hellerup is bordered on its north side by brightly-painted row houses, such as the one containing your apartment. At the east end is a dock, and if you go west you can catch a train.

You can see a street vendor and a wheelbarrow (empty) here.

The vendor eyes your mound of herring.

>w
Train Platform
The open-air train platform has a line that runs to Copenhagen every 10 minutes. There are no tickets: just line up and wait for the next train to come.

You can see a paper kroner here.

>w
You can't go that way.

* * *

>r
Time passes.

>enter
You get into the C-Train.

>t
That's not a verb I recognize.

>r
Time passes.

>exit
Copenhagen Metro Station
This is the main metro station in Copenhagen. Its creator won the Best Dane of the Year Award.

Stairs lead southward and upward to the IIT Campus exit. Christiana is northwest of here: this much you know.

The Danes are very efficient: you can also take a direct route from here to the Aarenhus Cemetery.

A small door stands in the southeast corner of the station near a fake tree.

You can see a C-Train (empty) here.

>r
Time passes.

* * *

>r
Time passes.

The C-Train departs without you.

>r
Time passes.

>s
IIT Campus
The campus is pretty sleepy in the summer. A construction crew works below the bell tower, but the only student you see is Ana.

You can see a woman named Ana here.

* * *

>give ana panties
You can only do that to something animate.

>give panties
(to yourself)
You can't give the pair of Central European panties to yourself.

>give Ana panties
You can only do that to something animate.

>i
You are carrying:
  a mound of herring
  a pair of Central European panties
  a backpack (open but empty)
  a wallet
    2 kroner
    1 Uncle Sam

>eat panties
That's definitely not edible.

>touch ana
You feel nothing unexpected.

>lick ana
That's not a verb I recognize.

* * *

>restart
Are you sure you want to restart?

* * *

>test uptodock
(Testing.)

>[1] test pack
(Testing.)

>[2] get pack
Taken.

>[3] test apt
(Testing.)

>[4] x fridge
Silver, yet subtle. The handle is quite affordant..

>[5] open fridge
You open the fridge, revealing a piece of cheese, a steak and a glass bottle.

>[6] x bottle
It contains some Dankdrinke.

In the glass bottle is some Dankdrinke.

>[7] open bottle
You open the glass bottle.

>[8] x dankdrinke
No drinke is more ergonomik than Dankdrinke!

>[9] drink dankdrinke
(first taking the Dankdrinke)
Your throat is filled with ergonomitivity.

[Your score has just gone up by one point.]

>[10] x sheets
Extremely rumpled from excessive romping.

>[11] x panties
Pink and frilly. You should probably return those.

>[12] x rug
The rug depicts a scene of universal healthcare flying over a lake.

>[13] take panties
Nice.

[Your score has just gone up by one point.]

>[14] test leave
(Testing.)

>[15] go south
(first opening the apartment door)

Hellerup Strandvejen
The main street of Hellerup is bordered on its north side by brightly-painted row houses, such as the one containing your apartment. At the east end is a dock, and if you go west you can catch a train.

You can see a street vendor and a wheelbarrow (in which are a pile of herring and a mound of herring) here.

The vendor eyes your wallet.

>[16] test vendor
(Testing.)

>[17] buy pile
You pay 1 kroner for the pile of herring, leaving yourself with 4 kroner.

The vendor eyes your wallet.

>[18] buy mound
You pay 2 kroner for the mound of herring, leaving yourself with 2 kroner.

The vendor eyes your pair of Central European panties.

>[19] test birdfood
(Testing.)

>[20] w

Train Platform
The open-air train platform has a line that runs to Copenhagen every 10 minutes. There are no tickets: just line up and wait for the next train to come.

You can see a paper kroner here.

>[21] feed pile to bird
You can't see any such thing.

I beg your pardon?

* * *

>w
Hellerup Strandvejen
The main street of Hellerup is bordered on its north side by brightly-painted row houses, such as the one containing your apartment. At the east end is a dock, and if you go west you can catch a train.

You can see a street vendor and a wheelbarrow (empty) here.

The vendor eyes your pair of Central European panties.

>w
Train Platform
The open-air train platform has a line that runs to Copenhagen every 10 minutes. There are no tickets: just line up and wait for the next train to come.

You can see a paper kroner here.

>take
(the paper kroner)
You gain 1 kroner.

>r
Time passes.

* * *

>r
Time passes.

The C-Train arrives.

>enter
You get into the C-Train.

>r
Time passes.

* * *

>r
Time passes.

You arrive in Copenhagen.

>exit
Copenhagen Metro Station
This is the main metro station in Copenhagen. Its creator won the Best Dane of the Year Award.

Stairs lead southward and upward to the IIT Campus exit. Christiana is northwest of here: this much you know.

The Danes are very efficient: you can also take a direct route from here to the Aarenhus Cemetery.

A small door stands in the southeast corner of the station near a fake tree.

You can see a C-Train (empty) here.

>go door
(first opening the small door)

The Path
This odd little path runs out of the metro station and toward an isolated hill overlooking the bay. The ground is grassy, but the only larger vegetation is a gnarled bush.

* * *

>exit
Copenhagen Metro Station
This is the main metro station in Copenhagen. Its creator won the Best Dane of the Year Award.

Stairs lead southward and upward to the IIT Campus exit. Christiana is northwest of here: this much you know.

The Danes are very efficient: you can also take a direct route from here to the Aarenhus Cemetery.

A small door stands in the southeast corner of the station near a fake tree.

You can see a C-Train (empty) here.

>s
IIT Campus
The campus is pretty sleepy in the summer. A construction crew works below the bell tower, but the only student you see is Ana.

You can see a woman named Ana here.

* * *

>w
Train Platform
The open-air train platform has a line that runs to Copenhagen every 10 minutes. There are no tickets: just line up and wait for the next train to come.

You can see a paper kroner here.

>take kroner
You gain 1 kroner.

I beg your pardon?

* * *

>r
Time passes.

The C-Train arrives.

>entere
That's not a verb I recognize.

>enter
You get into the C-Train.

* * *

>r
Time passes.

>e
You would have to get out of the C-Train first.

>exit
Copenhagen Metro Station
This is the main metro station in Copenhagen. Its creator won the Best Dane of the Year Award.

Stairs lead southward and upward to the IIT Campus exit. Christiana is northwest of here: this much you know.

The Danes are very efficient: you can also take a direct route from here to the Aarenhus Cemetery.

A small door stands in the southeast corner of the station near a fake tree.

You can see a C-Train (empty) here.

* * *

>s
IIT Campus
The campus is pretty sleepy in the summer. A construction crew works below the bell tower, but the only student you see is Ana.

You can see a woman named Ana here.

>x ana
A Czech girl. Starting next week, she's your TA for Introductory Programming. Starting last night, she's your lover.

>take ana
(putting the wallet into the backpack to make room)
You're carrying too many things already.

>i
You are carrying:
  a mound of herring
  a pair of Central European panties
  a backpack (open)
    a wallet
      3 kroner
      1 Uncle Sam

>drop herring
Dropped.

>take ana
Taken.

>i
You are carrying:
  a woman named Ana
  a pair of Central European panties
  a backpack (open)
    a wallet
      3 kroner
      1 Uncle Sam

* * *

>test uptodocl
>--> The following tests are available:
'test pack'
'test apt'
'test leave'
'test vendor'
'test bird-a'
'test docktoplatform'
'test uptodock'
'test wait-a'
'test etrain'
'test xtrain'
'test wait-b'
'test ceme'

>test uptodock
(Testing.)

>[1] test pack
(Testing.)

>[2] get pack
Taken.

>[3] test apt
(Testing.)

>[4] x fridge
Silver, yet subtle. The handle is quite affordant..

>[5] open fridge
You open the fridge, revealing a piece of cheese, a steak and a glass bottle.

>[6] x bottle
It contains some Dankdrinke.

In the glass bottle is some Dankdrinke.

>[7] open bottle
You open the glass bottle.

>[8] x dankdrinke
No drinke is more ergonomik than Dankdrinke!

>[9] drink dankdrinke
(first taking the Dankdrinke)
Your throat is filled with ergonomitivity.

[Your score has just gone up by one point.]

>[10] x sheets
Extremely rumpled from excessive romping.

>[11] x panties
Pink and frilly. You should probably return those.

>[12] x rug
The rug depicts a scene of universal healthcare flying over a lake.

>[13] take panties
Nice.

[Your score has just gone up by one point.]

>[14] test leave
(Testing.)

>[15] go south
(first opening the apartment door)

Hellerup Strandvejen
The main street of Hellerup is bordered on its north side by brightly-painted row houses, such as the one containing your apartment. At the east end is a dock, and if you go west you can catch a train.

You can see a street vendor and a wheelbarrow (in which are a pile of herring and a mound of herring) here.

The vendor eyes your pair of Central European panties.

>[16] test vendor
(Testing.)

>[17] buy pile
You pay 1 kroner for the pile of herring, leaving yourself with 4 kroner.

The vendor eyes your backpack.

>[18] buy mound
You pay 2 kroner for the mound of herring, leaving yourself with 2 kroner.

The vendor eyes your pile of herring.

>[19] test bird-a
(Testing.)

>[20] e

Dock
This is a shabby little dock used for the fishing trade. At the end of the dock, a little rowboat, moored with a rope, bobs up and down. In the rowboat is a large crate, atop which sits a bird.

>[21] feed pile to bird
The wretched bird regards you warily, then opens its beak and snaps up the pile of herring. It swallows in one gulp.

You see a flash of brilliance in its black, beady eyes. Then it caws, and flies off in the direction of Copenhagen.

You feel strangely proud.

[Your score has just gone up by one point.]

>w
Hellerup Strandvejen
The main street of Hellerup is bordered on its north side by brightly-painted row houses, such as the one containing your apartment. At the east end is a dock, and if you go west you can catch a train.

You can see a street vendor and a wheelbarrow (empty) here.

The vendor eyes your backpack.

>w
Train Platform
The open-air train platform has a line that runs to Copenhagen every 10 minutes. There are no tickets: just line up and wait for the next train to come.

You can see a paper kroner here.

* * *

>take
(the paper kroner)
You gain 1 kroner.

>w
You can't go that way.

* * *

>s
IIT Campus
The campus is pretty sleepy in the summer. A construction crew works below the bell tower, but the only student you see is Ana.

You can see a woman named Ana here.

>take ana
"Not now," she says. "Well, not here, at any rate."

>give ana
(to yourself)
(first taking the woman named Ana)
"Not now," she says. "Well, not here, at any rate."

>give panties
(to yourself)
You can't give the pair of Central European panties to yourself.

* * *

>give panties ana
You can only do that to something animate.

>give panties to aa
You can't see any such thing.

>give panties to ana
You can only do that to something animate.

* * *

>give panties to Ana
You can only do that to something animate.

>talk to ana
That's not a verb I recognize.

>talk ana
That's not a verb I recognize.

>speak ana
(to yourself)
There is no reply.

>speak
I didn't understand that sentence.

>speak to ana
I didn't understand that sentence.

* * *

>test uptopcope
>--> The following tests are available:
'test pack'
'test apt'
'test leave'
'test vendor'
'test bird-a'
'test docktoplatform'
'test uptodock'
'test wait-a'
'test trainto'
'test uptocope'
'test ana'

I beg your pardon?

>open tree
(the dwarf banana tree)
It isn't something you can open.

>open fake tree
You open the fake tree.

>enter tree
(the dwarf banana tree)
That's not something you can enter.

The C-Train departs without you.

>go fake tree
zone
You can see the fake tree here.

>l
zone
You can see the fake tree here.

* * *

>touch ana
You can't see any such thing.

>take ana
You can't see any such thing.

>gonear ana
IIT Campus
The campus is pretty sleepy in the summer. A construction crew works below the bell tower, but the only student you see is Ana.

You can see Ana and a stone bench here.

>take ana
Ana is incensed. "Trying to take me in in public?! What would your glorious Jefferson think of that?"

>give red to an
You can't see any such thing.

>give red to ana
You can't see any such thing.

>dddd
That's not a verb I recognize.

>purloin red. give red to ana
[Purloined.]

Ana sighs and kisses your cheek. She strolls over to the bench, and sits down to gaze at the flower.

[Your score has just gone up by one point.]

>touch ana
Mind your manners, American!

>take ana
Ana is incensed. "Trying to take me in in public?! What would your precious Lincoln think of that?"

* * *

>trace 5
[Parser tracing set to level 5.]

>eat bread
[ "eat" eat / "bread" bread ]
[Parsing for the verb 'eat' (1 lines)]

[line 0 * held -> Eat]
 [line 0 token 1 word 2 : held]
  [Object list from word 2]
   [NounDomain called at word 2
   seeking definite object
    Trying the wallet (663757) at word 2
    Trying 5 kroner (663789) at word 2
Parse_name called
Pass 1: 0 Pass 2: 0 Pass 3: 0
    Trying 1 Uncle Sam (663821) at word 2
    Trying the apartment door (664365) at word 2
    Trying yourself (663725) at word 2
Parse_name called
Pass 1: 0 Pass 2: 0 Pass 3: 0
    Trying the wallet (663757) at word 2
    Trying 5 kroner (663789) at word 2
Parse_name called
Pass 1: 0 Pass 2: 0 Pass 3: 0
    Trying 1 Uncle Sam (663821) at word 2
    Trying the backpack (663853) at word 2
Parse_name called
Pass 1: 0 Pass 2: 0 Pass 3: 0
    Trying the rug (663885) at word 2
    Trying the stove (663917) at word 2
    Trying the frying pan (663949) at word 2
Parse_name called
Pass 1: 0 Pass 2: 0 Pass 3: 0
    Trying the round window (663981) at word 2
    Trying the shelves (664013) at word 2
Parse_name called
Pass 1: 0 Pass 2: 0 Pass 3: 0
    Trying the loaf of bread (664045) at word 2
    Matched (1)
    Trying the dwarf banana tree (664077) at word 2
Parse_name called
Pass 1: 0 Pass 2: 0 Pass 3: 0
    Trying the fridge (664109) at word 2
    Trying the handle (664717) at word 2
    Trying the bed (664269) at word 2
    Trying bedsheets (664301) at word 2
Parse_name called
Pass 1: 0 Pass 2: 0 Pass 3: 0
    Trying the pair of Central European panties (664333) at word 2
Parse_name called
Pass 1: 0 Pass 2: 0 Pass 3: 0
   [ND made 1 matches]
  [Allowing object the loaf of bread for now]
  [token resulted in success]
 [line 0 token 2 word 3 : END]
[Line successfully parsed]

(first taking the loaf of bread)
You eat the loaf of bread. Not bad.

>trace off
[ "trace" trace / "off" off ]
[Parsing for the verb 'trace' (4 lines)]

[line 0 * -> TraceOn]
 [line 0 token 1 word 2 : END]

[line 1 * number -> TraceLevel]
 [line 1 token 1 word 2 : number]
  [token resulted in failure with error type 3]

[line 2 * 'on' -> TraceOn]
[line rejected for not ending with correct preposition]

[line 3 * 'off' -> TraceOff]
 [line 3 token 1 word 2 : 'off']
  [token resulted in success]
 [line 3 token 2 word 3 : END]
[Line successfully parsed]
Trace off.

>l
Apartment
Your apartment is a cheery little cube. On the east wall is a round window. A woven rug adorns the floor in the middle of the room. Along the west wall are a fridge and some shelves. A bed lies in the northwest corner, and a stove lies in the northeast.

On the stove is a frying pan.

You can also see an apartment door, a backpack (empty), a dwarf banana tree, a fridge (closed) and the bed (on which are bedsheets and a pair of Central European panties) here.

>eat bread
You can't see any such thing.

>eat panties
Foolish American, have you truly mistaken the pair of Central European panties for food?

>eat bckpack
You can't see any such thing.

>eat pack
Foolish American, have you truly mistaken the backpack for food?

>eat fridge
Foolish American, have you truly mistaken the fridge for food?

>eate pan
That's not a verb I recognize.

>eat pan
Foolish American, have you truly mistaken the frying pan for food?

>smoke pan
(first taking the frying pan)
You don't want to smoke the frying pan.

>drink pan
Foolish American, have you truly mistaken the frying pan for food?

>open handle
It isn't something you can open.

>pull handle
You open the fridge, revealing a piece of cheese, a steak and a glass bottle.

>open bottle
You open the glass bottle.

>l bottle
It contains some Dankdrinke.

In the glass bottle is some Dankdrinke.

>x dankdrinke
No drinke is more ergonomik than Dankdrinke!

>drink
What do you want to drink?

>it
(first taking the Dankdrinke)
Your throat is filled with ergonomitivity.

[Your score has just gone up by one point.]

I beg your pardon?

>l
Apartment
Your apartment is a cheery little cube. On the east wall is a round window. A woven rug adorns the floor in the middle of the room. Along the west wall are a fridge and some shelves. A bed lies in the northwest corner, and a stove lies in the northeast.

You can see an apartment door, a backpack (empty), a dwarf banana tree, a fridge (in which are a piece of cheese, a steak and a glass bottle (empty)) and the bed (on which are bedsheets and a pair of Central European panties) here.

>take panties
Nice.

>l panties
Pink, frilly, and definitely not yours.

>smell panties
Pervert.

>eat panties
Foolish American, have you truly mistaken the pair of Central European panties for food?

>taste panties
You taste nothing unexpected.

>put on panties
No way: you'd stretch them.

>take all
backpack: You're carrying too many things already.
dwarf banana tree: You're carrying too many things already.
piece of cheese: You're carrying too many things already.
steak: You're carrying too many things already.
glass bottle: You're carrying too many things already.
bedsheets: You're carrying too many things already.

>drop all
pair of Central European panties: Dropped.
frying pan: Dropped.
wallet: Dropped.

>take pack
Taken.

>take all
wallet: Taken.
frying pan: Taken.
pair of Central European panties: (putting the wallet into the backpack to make room)
Taken.
dwarf banana tree: (putting the frying pan into the backpack to make room)
Taken.
5 kroner: No need to do anything with that until you want to buy something.
1 Uncle Sam: (putting the pair of Central European panties into the backpack to make room)
Taken.
piece of cheese: (putting the dwarf banana tree into the backpack to make room)
Taken.
steak: (putting 1 Uncle Sam into the backpack to make room)
Taken.
glass bottle: (putting the piece of cheese into the backpack to make room)
Taken.
bedsheets: (putting the steak into the backpack to make room)
Taken.

>leave
But you aren't in anything at the moment.

>exit
But you aren't in anything at the moment.

>s
(first opening the apartment door)

Hellerup Strandvejen
The main street of Hellerup is bordered on its north side by brightly-painted row houses, such as the one containing your apartment. At the east end is a dock, and if you go west you can catch a train.

You can see an apartment door, a street vendor and a wheelbarrow (in which are a pile of herring and a mound of herring) here.

>go door
Apartment
Your apartment is a cheery little cube. On the east wall is a round window. A woven rug adorns the floor in the middle of the room. Along the west wall are a fridge and some shelves. A bed lies in the northwest corner, and a stove lies in the northeast.

You can see an apartment door, a fridge (empty) and the bed here.

>go door
Hellerup Strandvejen
The main street of Hellerup is bordered on its north side by brightly-painted row houses, such as the one containing your apartment. At the east end is a dock, and if you go west you can catch a train.

You can see an apartment door, a street vendor and a wheelbarrow (in which are a pile of herring and a mound of herring) here.

>touch herring
Which do you mean, the fistful of herring, the pile of herring or the mound of herring?

>pile
You feel nothing unexpected.

* * *

>transcript
Start of a transcript of

RYAN QUEST 2
An Interactive Fiction by Maxwell Joslyn
Release 1 / Serial number 181222 / Inform 7 build 6M62 (I6/v6.33 lib 6/12N) SD
Identification number: //EC20F892-AF27-40A2-8F4F-306D07A36092//
Interpreter version 0.5.2 / VM 3.1.2 / Library serial number 080126
Standard Rules version 3/120430 by Graham Nelson
Rideable Vehicles version 3 by Graham Nelson

>l
Apartment
Your apartment is a cheery little cube. On the east wall is a round window. A woven rug adorns the floor in the middle of the room. Along the west wall are a fridge and some shelves. A bed lies in the northwest corner, and a stove lies in the northeast.

On the stove is a frying pan.

On the shelves is a loaf of bread.

You can also see an apartment door, a backpack (empty), a dwarf banana tree, a fridge (closed) and the bed (on which are bedsheets and a pair of Central European panties) here.

>take all
backpack: Taken.
dwarf banana tree: Taken.
frying pan: (putting the wallet into the backpack to make room)
Taken.
loaf of bread: (putting the dwarf banana tree into the backpack to make room)
Taken.
bedsheets: (putting the frying pan into the backpack to make room)
Taken.
pair of Central European panties: (putting the loaf of bread into the backpack to make room)
Nice.

>eat all
You can't use multiple objects with that verb.

>smell
You smell nothing unexpected.

>smelll panties
That's not a verb I recognize.

>smell panties
Pervert.

>touch panties
You feel nothing unexpected.

>cook steak
You can't see any such thing.

>put steak
You can't see any such thing.

>open fridge
You open the fridge, revealing a piece of cheese, a steak and a glass bottle.

>take all
piece of cheese: (putting bedsheets into the backpack to make room)
Taken.
steak: (putting the pair of Central European panties into the backpack to make room)
Taken.
glass bottle: (putting the piece of cheese into the backpack to make room)
Taken.
Dankdrinke: The glass bottle isn't open.

>drink bottle
You open the glass bottle.

(first taking the Dankdrinke)
(putting the steak into the backpack to make room)
Your throat is filled with ergonomitivity.

[Your score has just gone up by one point.]

>enter bed
You get onto the bed.

>get off bed
You get off the bed.

Apartment
Your apartment is a cheery little cube. On the east wall is a round window. A woven rug adorns the floor in the middle of the room. Along the west wall are a fridge and some shelves. A bed lies in the northwest corner, and a stove lies in the northeast.

You can see an apartment door, a fridge (empty) and the bed here.

>enter bed
You get onto the bed.

>get out of bed
I only understood you as far as wanting to get outside.

>get out of the bed
I only understood you as far as wanting to get outside.

>get off
You get off the bed.

Apartment
Your apartment is a cheery little cube. On the east wall is a round window. A woven rug adorns the floor in the middle of the room. Along the west wall are a fridge and some shelves. A bed lies in the northwest corner, and a stove lies in the northeast.

You can see an apartment door, a fridge (empty) and the bed here.

>leave
But you aren't in anything at the moment.

>enter bed
You get onto the bed.

>leave
You get off the bed.

Apartment
Your apartment is a cheery little cube. On the east wall is a round window. A woven rug adorns the floor in the middle of the room. Along the west wall are a fridge and some shelves. A bed lies in the northwest corner, and a stove lies in the northeast.

You can see an apartment door, a fridge (empty) and the bed here.

>l
Apartment
Your apartment is a cheery little cube. On the east wall is a round window. A woven rug adorns the floor in the middle of the room. Along the west wall are a fridge and some shelves. A bed lies in the northwest corner, and a stove lies in the northeast.

You can see an apartment door, a fridge (empty) and the bed here.

>x window
Out the window you can see the Bay of Gentofte. Some way out in the water is a small island. From here it looks quite pleasant.

>x rug
The rug depicts a scene of universal healthcare flying over a lake.

>l rug
The rug depicts a scene of universal healthcare flying over a lake.

>l fridge
Silver, yet subtle. The handle is quite affordant.

>l shelves
Each of the shelves is thin enough to shave with.

>take alll
You can't see any such thing.

>l
Apartment
Your apartment is a cheery little cube. On the east wall is a round window. A woven rug adorns the floor in the middle of the room. Along the west wall are a fridge and some shelves. A bed lies in the northwest corner, and a stove lies in the northeast.

You can see an apartment door, a fridge (empty) and the bed here.

>s
(first opening the apartment door)

Hellerup Strandvejen
The main street of Hellerup is bordered on its north side by brightly-painted row houses, such as the one containing your apartment. At the east end is a dock, and if you go west you can catch a train.

You can see an apartment door, a street vendor and a wheelbarrow (in which are a pile of herring and a mound of herring) here.

The vendor calls out, "Today I have a pile of herring and a mound of herring! Fresh!"

>buy all
You can't use multiple objects with that verb.

>buy herring.
Which do you mean, the fistful of herring, the pile of herring or the mound of herring?

>pile
You pay 1 kroner for the pile of herring, leaving yourself with 4 kroner.

The vendor calls out, "Today I have a mound of herring! Fresh!"

>buy mound
You pay 2 kroner for the mound of herring, leaving yourself with 2 kroner.

>talk vendor
That's not a verb I recognize.

>eat vendor
Foolish American, have you truly mistaken the street vendor for food?

The vendor grins cheerfully.

>push vendor
The street vendor might not like that.

* * *

>uptodock
That's not a verb I recognize.

>testme
That's not a verb I recognize.

>test
>--> The following tests are available:
'test pack'
'test apt'
'test leave'
'test vendor'
'test bird-a'
'test docktoplatform'
'test uptodock'
'test wait-a'
'test etrain'
'test xtrain'
'test wait-b'
'test ceme'

>test uptodock
(Testing.)

>[1] test pack
(Testing.)

>[2] get pack
Taken.

>[3] test apt
(Testing.)

>[4] x fridge
Silver, yet subtle. The handle is quite affordant..

>[5] open fridge
You open the fridge, revealing a piece of cheese, a steak and a glass bottle.

>[6] x bottle
It contains some Dankdrinke.

In the glass bottle is some Dankdrinke.

>[7] open bottle
You open the glass bottle.

>[8] x dankdrinke
No drinke is more ergonomik than Dankdrinke!

>[9] drink dankdrinke
(first taking the Dankdrinke)
Your throat is filled with ergonomitivity.

[Your score has just gone up by one point.]

>[10] x sheets
Extremely rumpled from excessive romping.

>[11] x panties
Pink and frilly. You should probably return those.

>[12] x rug
The rug depicts a scene of universal healthcare flying over a lake.

>[13] take panties
Nice.

[Your score has just gone up by one point.]

>[14] test leave
(Testing.)

>[15] go south
(first opening the apartment door)

Hellerup Strandvejen
The main street of Hellerup is bordered on its north side by brightly-painted row houses, such as the one containing your apartment. At the east end is a dock, and if you go west you can catch a train.

You can see a street vendor and a wheelbarrow (in which are a pile of herring and a mound of herring) here.

The vendor eyes your pair of Central European panties.

>[16] test vendor
(Testing.)

>[17] buy pile
You pay 1 kroner for the pile of herring, leaving yourself with 4 kroner.

The vendor eyes your wallet.

>[18] buy mound
You pay 2 kroner for the mound of herring, leaving yourself with 2 kroner.

The vendor eyes your backpack.

>[19] test bird-a
(Testing.)

>[20] e

Dock
This is a shabby little dock used for the fishing trade. At the end of the dock, a little rowboat, moored with a rope, bobs up and down. In the rowboat is a large crate, atop which sits a bird.

>[21] feed pile to bird
The wretched bird regards you warily, then opens its beak and snaps up the pile of herring. It swallows in one gulp.

You see a flash of brilliance in its black, beady eyes. Then it caws, and flies off in the direction of Copenhagen.

You feel strangely proud.

[Your score has just gone up by one point.]

I beg your pardon?

>w
Hellerup Strandvejen
The main street of Hellerup is bordered on its north side by brightly-painted row houses, such as the one containing your apartment. At the east end is a dock, and if you go west you can catch a train.

You can see a street vendor and a wheelbarrow (empty) here.

The vendor eyes your backpack.

* * *

>enter
You get into the C-Train.

>e
You would have to get out of the C-Train first.

>r
Time passes.

>exi
That's not a verb I recognize.

>exit
Copenhagen Metro Station
This is the main metro station in Copenhagen. Its creator won the Best Dane of the Year Award.

Stairs lead southward and upward to the IIT Campus exit. Christiana is northwest of here: this much you know.

The Danes are very efficient: you can also take a direct route from here to the Aarenhus Cemetery.

A small door stands in the southeast corner of the station near a fake tree.

You can see a C-Train (empty) here.

* * *

>give ana panties
You can only do that to something animate.

>ana, take panties
You can't talk to the woman named Ana.

* * *

>x
(the wallet)
In the wallet is 5 kroner.

>i
You are carrying:
  a wallet
    $5 in kroner

* * *

>x
(the wallet)
In the wallet is 5 kroner.

>south
(first opening the apartment door)
You can't go to school without your backpack.

>ls
That's not a verb I recognize.

>get pack
Taken.

>south
(first opening the apartment door)

Hellerup Strandvejen
The main street of Hellerup is bordered on its north side by brightly-painted row houses, such as the one containing your apartment. At the east end is a dock, and if you go south you can catch a train.

You can see a street vendor and a wheelbarrow (in which are a pile of herring and a mound of herring) here.

>buy herring
Which do you mean, the fistful of herring, the pile of herring or the mound of herring?

>buy pile of herring
You pay 1 kroner for the pile of herring, leaving yourself with 4 kroner.

>buy mound of herring
You pay 2 kroner for the mound of herring, leaving yourself with 2 kroner.

>buy vendor
The street vendor doesn't cost any money.

I don't suppose the street vendor would care for that.

>buy fistful
The fistful of herring doesn't cost any money.

That seems to belong to the street vendor.

>i
You are carrying:
  a mound of herring
  a pile of herring
  a backpack (open but empty)
  a wallet
    2 kroner

>buy wheelbarrow
The wheelbarrow doesn't cost any money.

(putting the wallet into the backpack to make room)
Taken.

>i
You are carrying:
  a wheelbarrow
  a mound of herring
  a pile of herring
  a backpack (open)
    a wallet
      2 kroner

>buy boat
You can't see any such thing.

>go dock
You can't see any such thing.

* * *

>x
(the wallet)
In the wallet is 5 kroner.

>test me
(Testing.)

>[1] x fridge
The handle is quite affordant.

>[2] open fridge
You open the fridge, revealing a piece of cheese, a steak and a glass bottle.

>[3] x bottle
In the glass bottle is some Dankdrinke.

>[4] open bottle
You open the glass bottle.

>[5] x dankdrinke
No drinke is more ergönomik than Dankdrinke!

>[6] drink dankdrinke
(first taking the Dankdrinke)
You gulp the Dankdrinke.

* * *

>x bed
Shaped to perfectly fit the human body.

* * *

>x door
Just looking at this door makes you eager to start each day.

>doors
That's not a verb I recognise.

>exits
That's not a verb I recognise.

>exit
But you aren't in anything at the moment.

>look
Apartment
Your apartment is a cheery little box. On the east wall is a round window. A woven rug adorns the floor in the middle of the room. Along the west wall are a fridge and some shelves. A bed lies in the northwest corner, and a stove lies in the northeast.

On the stove is a frying pan.

On the shelves is a loaf of bread.

You can also see a fridge (closed) and a bed (on which are bedsheets and a pair of Central European panties) here.

* * *

>x fridge
Silver, yet subtle. The handle is quite affordant..

>open fridge
You open the fridge, revealing a piece of cheese, a steak and a glass bottle.

>pull fridge
It is fixed in place.

>look cheese
You see nothing special about the piece of cheese.

* * *

>x bottle
In the glass bottle is some Dankdrinke.

>x dankdrinke
No drinke is more ergönomik than Dankdrinke!

>drink dankdrinke
The glass bottle isn't open.

* * *

>open bottle
You open the glass bottle.

>drink dankdrinke
That's plainly inedible.

* * *

>pull handle
You open the fridge, revealing a piece of cheese, a steak and a glass bottle.

>take bottle
Taken.

>drink bottle
That's plainly inedible.

>drink dankdrinke
The glass bottle isn't open.

>reload
That's not a verb I recognize.

* * *

>x frige
You can't see any such thing.

>pull handle
You open the fridge, revealing a piece of cheese, a steak and a glass bottle.

>x bottle
In the glass bottle is some Dankdrinke.

>take bottle
Taken.

>drink
(the glass bottle)
That's plainly inedible.

You gulp down the glass bottle.

* * *

>x handle
Quite affordant.

>x fridge
Silver, yet subtle. The handle is quite affordant..

* * *

>x sam
The hardest currency on Earth.

A single tear leaks out as you contemplate the majesty of the USD.

* * *

>x sheets
Your sheets are rumpled from romping.

* * *

>x shelves
Each of the shelves are thin enough to shave with, yet strong enough to support a loaf of bread.

On the shelves is a loaf of bread.

>h
That's not a verb I recognize.

* * *

>x shets
You can't see any such thing.

>x sheets
Extremely rumpled from excessive romping.

>x panties
Pink and frilly. You should probably return those.

* * *

>x spirit
You can't see any such thing.

>spirit
That's not a verb I recognize.

>take spirit
You can't see any such thing.

>look
Apartment
Your apartment is a cheery little box. On the east wall is a round window. A woven rug adorns the floor in the middle of the room. Along the west wall are a fridge and some shelves. A bed lies in the northwest corner, and a stove lies in the northeast.

On the stove is a frying pan.

On the shelves is a loaf of bread.

You can also see a dwarf banana tree, a fridge (closed) and a bed (on which are bedsheets and a pair of Central European panties) here.

>x panties
You see nothing special about the pair of Central European panties.

* * *

>x tree
As friendly as a plant can get.

>x handle
Quite affordant.

* * *

>x wallet
In the wallet is 5 kroner.

What do you do?

>take
What do you want to take?

What do you do?